あの頃の僕は　きっとどうかしていたんだね	失すものはなにもない　君の他には
でも君はいつも　そんな顔して	あの頃の僕は　きっとどうかしていたんだね
あなたを連れてゆくよ	手を離さないで
君の嫌いな東京も　秋はすてきな街	でも大切なことは　ふたりでいること
消えないうちに愛を　預けておくから	切ないときには　開けてみればいい
君が思うよりきっと　僕は君が好きで	でも君はいつも　そんな顔して
どんどん孤独になってく	自分が怖い
みんなとのバカ話も笑えない	自然に話しかけてく　あなたが怖い
別に　初めてじゃないってことで	みんなにそう言ってたし…
あなたの笑顔が眩しい	みんなといる時だって　好きすぎる
他に　好きな人がいたの　私	なのに　心奪われた
いつもの仲間と一緒に　ドライブしたり	賑やかなままがよかった
あの夜に　ねえ　戻して	口付けの　前に　戻して
あなたをまっすぐ見れない	みんなとのバカ話も笑えない
不良の真似事だったわ	あのキスで　変わった
都会で仲間が出来て　うれしかったの	不良の真似事だったわ
自分が怖い	その胸で　ねえ　支えて
どうして　恋人になれないの?	じゃ　どうして　口づけをしたの?　あの夜
どうして　二人では会えないの?	じゃ　どうして　電話してくるの?　たまに
自然に話しかけてく　あなたが怖い	あの夜に　ねえ　戻して
みんなといる時だって　好きすぎる	どんどん孤独になってく
賑やかなままがよかった	あのキスで　変わった
孤独な夜が続いてる	涙も出ないわ　さみしいな　さみしいな
頭の中が壊れそうで	眠りにつけない　苦しいな　苦しいな
一回限りの人生	もう迷ってる暇はないんだから
そう誰かのせいにしても戻らない青春	夢と現実
子供の頃みたく	透明な心
現実　受け止められず	そう誰かのせいにしても戻らない青春
なんかうらやましい	負けちゃいられない　いられない
透明な心	どこに閉じ込めちゃったろう…
何回でもいい再チャレンジ	そう　そこから始まるサクセスストーリー
あの子の描く夢	なんかうらやましい
眠りを知らない街	あなたとなら恐くないわ
曲がりくねった道を駆け抜けよう	回り道なんてね、冗談でしょ☆
かけがえのない　最高のバディ	いつだってパワーをくれる
ノーテンキな青空	トラブルなら日常のこと
愛だの恋だのじゃ計れないのよ	曖昧なルールの無いコンビネーション☆
ギリギリの綱渡りでも	加速したなら チェックメイト!!
張りつめたアスファルト	ノーテンキな青空
かけがえのない　最高のバディ	ギリギリの綱渡りでも
鳴り止まないサイレン	眠りを知らない街
シグナルはいつも点滅	テンションあげて　レブオーバー!!
真実はたったヒトツだけ	かけがえのない　最高のバディ
トラブルなら日常のこと	狙い定めてイグニッション!!
ブレーキなんて要らないさ	無敵のサイン　フルスロットル
譲れないキズナ　あなたが	かけがえのない　最高のバディ
いつだってパワーをくれる	あなたの笑顔守りたいよ
もうこのシートは譲らない	廻り逢い繋がる証
かけがえのない　最高のバディ	シグナルはいつも点滅
向かうところ敵無しだわ	簡単に諦めてあげない!!
このアイコンタクトが	つくりだすマイティー・パワー
あなたとなら恐くないわ	絶対に涙は見せない!!
かけがえのない　最高のバディ	ブレーキなんて要らないさ
つくりだすマイティー・パワー	向かうところ敵無しだわ
廻り逢い繋がる証	唯一無二の存在だよ
帰ってきた　あなたの横	もうこのシートは譲らない
見た目だけで何が分かるんだろう？	勝手に決めつけられる肌色
勝手に決めつけられる肌色	どこにあるの？私の居場所
怒ってないフリもできる	悲しくないフリもできる
何でも分かってるって思ってるんだろう？	見た目だけで何が分かるんだろう？
自分のために生きたい	でも今はまだ…
聴こえる？　私たちの音が歪む	日が沈む　そしてまた気付く
悲しくないフリもできる	何ともないフリもできる
流した涙の訳	君には分かってたんだね
忘れてたよ大切な人なのに	失うこと考えたくもない
何も言わないで	誰のせいでもない
笑顔でいてくれたね	忘れてたよ大切な人なのに
何も聞かないで	しゃべりたくない
言い聞かせる	忘れてたよ大切な人なのに
いつも“また今度”	だからこの瞬間　あの瞬間
君の周りも変わってくから	自分は変わらなくとも
「あ〜、あの時にああしとけば」とか	人はいつも後になって
これからもそう	頼って頼られて
笑っていますように	また会えますように
時に進まないといけない	「あ〜、あの時にああしとけば」とか
あなたが幸せで	笑っていますように
信じていたい	今日もどこかで
いっぱいあるケド	いつも“また今度”
今日もどこかで	あなたが幸せで
自分は変わらなくとも	時に進まないといけない
地球が回ってるように	君の周りも変わってくから
だからこの瞬間　あの瞬間	1つ1つを大切にして
私は1人じゃない	だからここまでこれた
そうやって育ってくんだ	分かってくんだ
だからここまでこれた	これからもそう
人はいつも後になって	気付くことがあるケド
聞きたいコト　話したいコト	いっぱいあるケド
頼って頼られて	生きてく
生きていきたい	信じていたい
気付くことがあるケド	そうやって育ってくんだ
1つ1つを大切にして	生きていきたい
もしも誰かが　困っていたなら	アナタが今　気付いてあげられる
ほんの一言　かけるダケで	何かが　変わるかもしれない
1人1人の　その笑顔で	たくさんの　愛情で
たくさんの　愛情で	もっと(もっと)　もっと(もっと)
変えていける　この世界を	もっと(もっと)　もっと(もっと)
人の感情も考え方も	みんな違うケド
ほんの少しだけ　想い合うダケで	何かが変わるかもしれない
今もどっかで	誰かが泣き続けてる
今も誰かが誰かをキズ付け	今もどっかで
1人1人の力で	変えていける　この世界を
アナタが今　気付いてあげられる	ほんの一言　かけるダケで
「もう泣かないで…」	いつもそばで聞こえてる
誰なのか　分からない…	だけど　感じてる
全て見えてくる	いつのまにか　笑みもこぼれるの
耳すませば　叶えてくれてた	私の中　やさしく光る
誰なのか　分からない	だけど　感謝してる
いつもそばで聞こえてる	信じれば見えてく何かが
私の肩　やさしく包む	誰なのか　分からない…
私が私であるために	見守ってくれてた
「そう、羽ばたいて…」	いつもそばで聞こえてる
信じれば見えてく何かが	私の肩　やさしく包む
全て消えてく	いつのまにか 傷も癒えてくの
私の中　やさしく光る	誰なのか　分からない
あせる時間と距離の中不安にもなるけど	“愛してる”なんて言われたらもう
隠してた感情も	涙に変わって流れてく
何度わがまま言ったかな…	そのたびあなたの事困らせた
気づいたらあなたのこと　いつのまにか意識してて	素直に今伝えられる　勇気くれたから…
そのたびあなたの事困らせた	あせる時間と距離の中不安にもなるけど
雨上がりの様なキスで	私をやさしくそっと起こしてくれる
いつも君の味方だよ	いつもそう思うほどのことしてくれたから
涙に変わって流れてく	閉じかけた心のドア
閉じかけた心のドア	開けてくれたから…
思い出せばいつも偶然どっかで会えてた…	そんなことがすごくうれしくて
何があったとしても	いつも君の味方だよ
何でも出来る君がパワーくれるから	笑顔でいられるいつまでもずっとこのままで
私をやさしくそっと起こしてくれる	あなたのかわりなんて
明日の風も一緒に感じてたいから	どんなときも　そう　そばに居てくれたから…
確信できる　信じさせてくれるから	安心できる　いつまでもずっとこのままで
また同じ　朝が来て	自由を味わうために捧げる
秒刻み　スケジュール	真昼の悪夢が動き出す
真昼の悪夢が動き出す	息詰る　義務感と
自由を味わうために捧げる	まだまだ　頭が
まだまだ　頭が	カラダ動かしてる　時間と戦う
息詰る　義務感と	夜までの距離感を楽しんでる
何も合わない2人が	出会った頃は
笑っちゃうぐらい	合わないよね
また思い出す	キミと過ごした日々は
観たい映画も	服の趣味も
会っていくうちに	結局キミを大好きになってた
春は花見で	夏は海へ
服の趣味も	笑っちゃうぐらい
同じ太陽　同じ星空の下で	キミに会えたから
こうやって時が経って	会っていくうちに
キミと過ごした日々は	宝物だから
出会った頃は	別に興味もなくて
別に興味もなくて	ただの友達
ただの友達	でも
でも気にしない	バラバラでも
いいんじゃない	同じ太陽　同じ星空の下で
夏は海へ	秋はハロウィーンで
季節が変わるたび	また思い出す
合わないよね	でも気にしない
バラバラでも	いつも一緒に笑えるから
恋すれば誰もがかかる魔法に	アンバランスな2人だって
キミに会えたから	出会えたから
アンバランスな2人だって	いいんじゃない
冬はクリスマスタイム!!	こうやって時が経って
秋はハロウィーンで	冬はクリスマスタイム!!
許せなくて	どうしようもないくらい
今も　悔しくて	許せなくて
きっとすべてがうまくいくから	あなたが頑張ってるから
あなたの心配事は	ちゃんと伝わってるから
超えていける	信じてるから　あなたのことを
どうしようもないくらい	苦しいときもある
苦しいときもある	それでもあなたは絶対に！あきらめない
汗ばむこの肌	揺れ動く花のよう...
きらめくライトの中	汗ばむこの肌
君は何を残す?後悔する?	それとも全てを受け入れられる?
ただ…過ち ほっとかないで	君はそれを変えてけるから!
過ちを恐れないで 自分が信じてやるコト	ただ…過ち ほっとかないで
君はそれを変えてけるから!	敵とか味方じゃない自分との戦い
あぁイマ、イマ!	人と人はいつだって
夜は人を寂しくさせるケド	きっとまた朝が来れば...
ただ抱きしめて	あぁイマ、イマ!
何をイマ　考えてるのか　分からない	お互いの間に見えない壁が
間違えることを恐れないで	自分のコトを信じて...
あぁイマ、イマ!	どんなに間違えたって
変えていける	あぁイマ、イマ!
思わすそんな日だって	変えていける
生きるんだ支え合って	耳を澄まして
子供たちはいつだって	あなたのことを頼ってる
いつだって1人だって	思わすそんな日だって
お互いの間に見えない壁が	気がつけばそこに　あたり前のように
耳を澄まして	あぁイマ、イマ!
あぁイマ、イマ!	子供たちはいつだって
思えるように	あぁイマ、イマ!
人と人はいつだって	生きるんだ支え合って
遠ざかってく距離　近づきたいのに	居場所がもう無い　何も言えない
あなたのことを頼ってる	ただ抱きしめて
気がついて欲しい　ココにいることを	夜は人を寂しくさせるケド
どんなに間違えたって	「私はできるんだ」って
「私はできるんだ」って	思えるように
居場所がもう無い　何も言えない	気がついて欲しい　ココにいることを
気がつけばそこに　あたり前のように	遠ざかってく距離　近づきたいのに
しがみつかない	そんな弱くない
努力してきたから	私のこと　知ったふりして
微妙な空気...　空気	飲み込まれそうになるから
何度も何度も	努力してきたから
そんな弱くない	痛みなんて
だケドこのままじゃ	何もできない
痛みなんて	飲み込んでやる
私のこと　知ったふりして	テキトーなこと言わないで
少し握れば割れてしまうような	そんな不安は私にはないから
不安とばして	こんな世の中だって
こんな世の中だって	やれる何だって
後悔したくない	後戻りはない
集めて新しい	自分のパズル
繰り返すこの旅は	迷路のように
ひとりでここまで	来たわけじゃない
ぶち当たるこの壁も	突き抜ける
本当の存在	探し出すために
探し出すために	ガラスの破片を
鏡をのぞきこむ	自分が見えない
自分が見えない	本当の存在
ガラスの破片を	集めて新しい
この手でつかむんだ	後悔したくない
やれたわけじゃない	ひとりでここまで
後戻りはない	もう誰にも止められない
突き抜ける	強くいることの答えなど
何でも最初から	やれたわけじゃない
色も何だって	関係ないって
自分のパズル	組み立てるんだ
迷路のように	ぶち当たるこの壁も
強くいることの答えなど	知らないけど
知らないけど	私なりに行くんだ
心の中にいつでも	感謝の気持ちと
来たわけじゃない	心の中にいつでも
形何だって	色も何だって
やってみないと分からない	動かなきゃ始まらない
ムリだなんて言わないで	やってみないと分からない
君がいれば	何も恐くない
このトゲも　もう人には向けない	必要ない
この手だけなら　ここで　もう...	その手となら　もっと届くよ
君がいなきゃ	何もできない
何もできない	ただそばにいて
手をにぎって	君がいれば
なにげなく空見上げて	1日に感謝したくなる
あの空も	飛び越えて
1日に感謝したくなる	愛や弱さ見せることを
あの山も	あの空も
誰もが通るみち	笑顔や感動は
飛び越えて	風を感じたい
愛や弱さ見せることを	恥ずかしいと思わないで
笑顔や感動は	涙無しじゃつくれない
誇り高く　胸張って	その炎を消さぬように
一人一人の心一つに	信じることを恐れないで
それでも　構わない	僕は　進む
僕は　進む	繰り返し　夢の中で　溺れたくない
今　苦しみの無い場所	求め 燃え上がる　炎の中へ
揺れてる　気持ちは	この　胸の奥に　隠して
希望の欠片を	拾って　また　失くして
季節は巡り巡る	ここから　新しい旅に出よう
このままじゃ　生きられない	カケガエノナイもののために
水面に浮かぶ月	掴みたくても　掴めない
拾って　また　失くして	じゃあ　何の為に　誰の為に
この　胸の奥に　隠して	その先に　何があるかなんて
でも今は　暗闇の中	僕の声なんて　誰も聴こえない
このままじゃ　生きられない	この手で　明日の光を
じゃあ　何の為に　誰の為に	僕は闘うの?
優しく　風が吹く	水面に浮かぶ月
何度でも　諦めずに	今日も進もう　振り向かない
今日も進もう　振り向かない	いつの日か　愛されたい
繰り返し　夢の中で　溺れたくない	このままじゃ　生きられない
ここから　新しい旅に出よう	さぁ　今 胸を張って
いつの日か　愛されたい	ただ　それだけ
あの雲の流れにそって	空高く　舞い上がるんだ
空高く　舞い上がるんだ	苦しまない　痛みもない
苦しまない　痛みもない	そんな場所なんてあるの?
光に 触れたい	でも今は　暗闇の中
その先に　何があるかなんて	わからない
愛しいと思ってしまう	ケンカをしてもいつも
その何でもないよな言葉さえも	キミがするコト全部
ワタシの名前を呼んでいて欲しい	いつまでもずっと
アナタが笑えば	すぐに笑ってしまう
ケンカをしてもいつも	アナタが笑えば
すぐに笑ってしまう	その笑顔にやられてしまうの
何でもないよな仕草と	その何でもないよな言葉さえも
キミがするコト全部	愛しいと思ってしまう
それでもあふれる	涙がまたこぼれてく
出会いや別れ	繰り返すたび
繰り返すたび	きっとまたあなたを想う…
胸につきささる	そして「いつかまた会おうの。」と…
空を見上げれば	雲や流れ星
こらえる。人は。	それでもあふれる
愛し、愛されて	出会いや別れ
見送る時くらい	笑顔でいたい
握りしめながら	こらえる。人は。
時に傷ついて	愛し、愛されて
小さなかけらを	握りしめながら
静かに光る	この瞳に映る
この瞳に映る	あなたも今見てるかな…？
雲や流れ星	静かに光る
愛は刃物より	胸につきささる
キミと時を越えてくでしょ	どんなことからも守るから
どんなことからも守るから	たとえ何かを失ったとしても….
いつも今もこの先もずっと	キミと時を越えてくでしょ
力を合わせれば	無限大の力になる
涙を流しても	前を向こう
前を向こう	傷付かない人なんていないんだから
傷付いても	涙を流しても
不可能なコトなんてない	目指す未来は同じさ
争いを止めて	力を合わせれば
目を閉じて　思い描く	希望の光を
何度も	傷付いても
無限大の力になる	勇気を出して　歩き出そう
目指す未来は同じさ	一人じゃないから
外への扉を開けば青い空	いつでも迎えてくれるの
空港に着いた時の　あの香り	今でも忘れられない　飛んで行きたい…
今でも忘れられない　飛んで行きたい…	外への扉を開けば青い空
ドライブ　テーマパーク	焦らずのんびり楽しみたい!!
海とショッピングモールと	ドライブ　テーマパーク
髪形を変えても	あなたはここにいないし
会う時間も無い	「また別の日に…」
2人だけの時間が欲しかった	それだけなのに…
どんなにオシャレしても	髪形を変えても
「また別の日に…」	とか 意味分からない
あなたはここにいないし	会う時間も無い
あなたのために	こんなに尽くしてるのに
とか 意味分からない	私じゃダメなの??
思ってたのに	ため息ばかり
ため息ばかり	どこにいても
こんな時には	何を　(言えば)
会いたい　(会えない)	話したい　(もう話せない)
彼のこと	もういいと
うわのそらで…	瞳をとじて想う
話したい　(もう話せない)	こんな時には
どこにいても	うわのそらで…
何を　(言えば)	今さら　(何をすれば)
数えきれないホド	思い出す
思い出す	夢のような出会いから
もういいと	思ってたのに
キミはもういないのに…	手につかない　(仕事も何もかも)
今さら　(何をすれば)	キミはもういないのに…
人を大事に	自分も大事に
勇気を出して少しずつ	泣いて　笑って　また進む
いつの日か　叶うから	いつの日か　叶うから
間違えたっていいじゃない	何度でも立ち上がれる
忘れないで　1人じゃないよ	恐れないで　愛することを
今を大事に	人を大事に
恐れないで　愛すること	間違えたっていいじゃない
きっと明日はいい日だから	きっと明日は晴れるから
泣き虫だっていいじゃない	たまには頼っていいじゃない
あなたとの思い出が　溢れ出す一瞬で	忘れないでいてね　いつも君を大好きだよ
あなたにとって　大切な人だったら	私にとっても　大切な人だから
一緒に笑って　いっぱい笑って	ここから始まる新しい1日が(ああ、素晴らしい)
私にとっても　大切な人だから	一緒に笑って　一緒に語り合って
誰に何を言われたってあなたは	私にとって　大切な人だから
私も安心して　ゆっくり過ごせるから	どこにいたって　繋がってるから
私にとって　大切な人だから	一緒に笑って　一緒に語り合って
全ての嫌なことや　悩みとか一瞬で	忘れさせてくれる　その笑顔にありがとう
ここから始まる新しい1日が(ああ、素晴らしい)	あなたが安心できる場所を　見つけたなら
私にとって　大切な人だから	一緒に笑って　いっぱい笑って
一緒に笑って　一緒に語り合って	そしてまたいつものように
どこにいたって　繋がってるから	そう、いつだって想ってるよ
そう、いつだって想ってるよ	君のことを守るよ
あなたが安心できる場所を　見つけたなら	私も安心して　ゆっくり過ごせるから
一緒に笑って　一緒に語り合って	きっと分かり合えるから
努力して夢見たなら	上を向いて 歩いていくから
いつまでたっても捨てられない…ない	君は笑うだろう 別にいいけど
そう思っているほうがイイ	顔も体も もらったものが一番イイ
なりたい自分になれるように信じて	これからだって 他の誰かにはなれない
世界で1つの自分だから…だから	素敵な人に あこがれるのはいい
私なんかなんて 言うのはやめて	世界で1つの自分だから…だから
やぶれたタイツと つぶれたハイヒールを	いつまでたっても捨てられない…ない
素敵な人に あこがれるのはいい	ケドみんな同じじゃつまらないじゃない…じゃない?!
輝いていたい女だから	努力して夢見たなら
君は笑うだろう 別にいいけど	見た目だけで何が分かる…分かる?
やり残したとか　後悔なんてイヤ!!	だから今を　精一杯感じたい!!
マチがえるコト　たくさんあるケド	そこから覚えるコトも　たくさんあるから
大きな声で　ありあまった力	出し尽くすまで
そこから覚えるコトも　たくさんあるから	やり残したとか　後悔なんてイヤ!!
やりたいコトとか　多すぎるから	いてもたってもいられなくなるの!!
裸足になって　歌おう	大きな声で　ありあまった力
あなたが元気に	あなたが楽しく
みんなが幸せに	街中が笑える未来へ
あなたが楽しく	みんなが幸せに
笑顔こぼれるメロディー	どこまでも届け！愛！！
どこまでも響け！愛！！	街中が輝く未来へ
どこまでも届け！愛！！	街中が笑える未来へ
どんどん増えるハーモニー	どこまでも響け！愛！！
すべてをつなぐエナジー	笑顔こぼれるメロディー
金色に輝け	私達の未来よ
今もこの世界で終わらない争いや絶望	でも共に立ち上がれば
やれることはもう	やり尽くしたよと
やり尽くしたよと	彼女は笑うの…
小さな声で言うの…	やれることはもう
でも共に立ち上がれば	暗闇も光に変わる
私達の未来よ	裸の自分を愛せる未来を
心が疲れたと	小さな声で言うの…
でもますますボルテージ上がる	嫌なことは全部汗とともに
嫌なことは全部汗とともに	流して忘れる夜明けとともに
ただ楽しみてぇーただ集まりてー	ただ後悔だけはしたくないぜー
ただ後悔だけはしたくないぜー	からメモリーつめるだけメモし夢のシーン
時はたってくあっという間に	カラダ揺らしてそう気ままに
ちぇいメンソーレ即絡もうぜ	みんなで騒げや鬼に金棒で
流して忘れる夜明けとともに	さあ前に前に後悔する前に
でもますますボルテージ上がる	嫌なことは全部汗とともに
嫌なことは全部汗とともに	流して忘れる夜明けとともに
ただ楽しみてぇーただ集まりてー	ただ後悔だけはしたくないぜー
ただ後悔だけはしたくないぜー	からメモリーつめるだけメモし夢のシーン
時はたってくあっという間に	カラダ揺らしてそう気ままに
ちぇいメンソーレ即絡もうぜ	みんなで騒げや鬼に金棒で
流して忘れる夜明けとともに	さあ前に前に後悔する前に
ゴマカス言葉とか	約束とかいらないから
もうすぐ行かなくちゃ	つぶやく君の声に
思い出すトキにはいつでも	元気にさせてくれるキミの
数えきれないほど泣いて	数えきれないほど笑い合って
パパとママがくれた名前も	数えきれないほど呼び合ってたネ…
今どこで何してるだろう?	思い出すトキにはいつでも
元気にさせてくれるキミの	その笑顔は私の心の太陽
夜の道をさまよい歩き続けた	2人だったら何でも出来るそんな気がしてた
数えきれないほど笑い合って	パパとママがくれた名前も
悪いことして知らないフリ	人を傷つけて楽しんでる
何か気に入らないとすぐ	キレる　脅す　バックレる
最後は必ず正義が勝つ	最後は必ず正義が勝つ
そうじゃないなら気を付けな	あなたの自由はあと少し
良いことすれば　良いことが	そうじゃないなら気を付けな
力で相手をコントロール	自分より強そうな人には　ゴマすってる
一人じゃ何もできないくせに	力で相手をコントロール
今では過去の話	わざと合わせない視線やりきれない
追っかけてたでしょ！	最終宣告は言わせて
どこで間違ってたんだろう	忙し過ぎたのがいけなかったの？
わざと合わせない視線やりきれない	もうこれ以上、要するに
どこにも進まない	最終宣告を言ったら
忙し過ぎたのがいけなかったの？	そっちだって女の事
もうこれ以上、要するに	どこにも進まない
そっちだって女の事	追っかけてたでしょ！
フレームの中にいた2人	今では過去の話
うまくいってたハズなのに	どこで間違ってたんだろう
乱した髪をなびかせ 波風にそっと	肩に手まわし 私を抱き寄せ!!
この日を待ってました!!	夏が来たからには行こうか!?
待ってる時がきました	乱した髪をなびかせ 波風にそっと
この音に乗って 鼓動にまかせて	子供に戻って 思い切って騒いで
夏が来たからには行こうか!?	海が呼んでるように聞こえる
このまま時間が止まればいいのに	ずっと君といられるなら どんなに幸せだろう
ずっと君といられるなら どんなに幸せだろう	砂浜に書いた文字はもう 波にさらわれ消えたけど
さあみんな乗りな まだ間に合うこっちだ	たまには好きなコトをして はしゃいで
この音に乗って 鼓動にまかせて	子供に戻って 思い切り騒いで
ずっとキミといられるなら どんなに幸せだろう	砂浜に書いた文字はもう 波にさらわれ消えたけど
このまま時間が止まればいいのに	ずっとキミといられるなら どんなに幸せだろう
この日を待っていました!! 夏が来たからには行こうか!?	海が呼んでるように聞こえる
さあみんな乗りな まだ間に合うこっちだ	たまには好きなコトをして はしゃいで
夏の太陽	自然にはさからえない
今はこの気持ち	言うのか言わない方がいいのが
目と目が合うだけで、、なんなんだろう、、	もうドキドキが止まらないなんでだろう、、
言うのか言わない方がいいのが	迷う、、でも、、
“生まれてきてくれてアリガトー”って	心から“会えて良かったナー”って
会うべき人に引き寄せられてく	不思議だケド 素敵なコトじゃない?!
理由なくても きっと誰もが	見えない何かに引き込まれてく
幸せな気分にさせてくれる…	“生まれてきてくれてアリガトー”って
見えない何かに引き込まれてく	そしていつか出会えた時には
偶然じゃない きっと誰もが	会うべき人に引き寄せられてく
どんな問題でも	乗り越えていけるから
ひとっとび　かっとび	またこけるたんび　ほころびる
時々もれる陽　あびるのみ	空もほろびるほどのビルのびる
がしかと生きのびるオレ	八起き七転び
胸の奥に響いて涙	あふれてる
またこけるたんび　ほころびる	がしかと生きのびるオレ
すくなすぎるぜ	すきまからかまみる
(平等なもんはそんなもんだけ)	60何億分のなれの果て
あるいはいい気分で	死んでくため
ハナタカダカ	(へしおるどまんなか)
カンペキじゃないケド	どんな問題でも
(へしおるどまんなか)	ありんこみたくせまる波
すきまからかまみる	どえらい波にのる旅
ほしけりゃあんだろう	明日なんて　どんなもんだって
60何億分のなれの果て	(アラワザで
あからさまにみえないなかなか	たかだか　あんぐらいで
どの街にもうもれたタカラさがす	あからさまにみえないなかなか
ありんこみたくせまる波	写真じゃいたくでかいのに
そのつどいつなんどき	時々もれる陽　あびるのみ
明日なんて　どんなもんだって	流れてくだけ　くりかえすだけ
乗り越えていけるから	君がいるなら
写真じゃいたくでかいのに	すくなすぎるぜ
私がどれだけ本当に	やれるのか　見せるから!!!
少しのミスを　犯したとしても	私はくずれない
たかだか　あんぐらいで	ハナタカダカ
こわくなって　逃げ出したくなって	新しい環境に目をつぶる日々
それとひきかえに	私がどれだけ本当に
もう投げ出すの？	そんな訳にはいかない
自分で決めたコトなのに	もう投げ出すの？
チカラあるから	カンペキじゃないケド
流れてくだけ　くりかえすだけ	(平等なもんはそんなもんだけ)
じゃあ何のために	自分で決めたコトなのに
こたえだしてく	そのつどいつなんどき
どいつもこいつも	ほしけりゃあんだろう
またいでく旅　ナイバビ	ひとっとび　かっとび
空もほろびるほどのビルのびる	どの街にもうもれたタカラさがす
私はくずれない	チカラあるから
思うように届かない時もあるけれど	諦められない　何かがあるから
迷っても結局最後は自分が決めるコト	つまらない争いや愚痴を
どうすれば変えられる運命を…	分からないのに最初から諦めるの!?
だから進む　どんなにさえぎられても	思うように届かない時もあるけれど
諦められない　何かがあるから	この瞳で　この胸で　この手で
どうすれば起こせる奇跡を…	迷っても結局最後は自分が決めるコト
つまらない争いや愚痴を	言ってる暇はない　ケド時に惑わされる
いつも見慣れてる顔が疲れてる	メイクアップしてみても心からは笑えない
こんなに待ってても何の特もない	どうしようもない
おそれないで かけてみようって	歩いてけるから この先もずっと
メイクアップしてみても心からは笑えない	いつも身に付けてるこのアクセサリーも
私のコト忘れたりしないカナ?	ただ安心したいだけの1コール
その日がいつか来るから	その時ももしキミがいるなら
会えない時間が多スギたら	私のコト忘れたりしないカナ?
かなりヤバめな人混みの中	横の人ともコミュニケーション
最後あけましょう　みなでシャンパン	今日はココでストレス発散!!
本気で汗かいてびしょ濡れ　目ん玉瞳孔開いて挑むぜ	血管ブチ切れる直前　アドレナリン増加
でも隠したい自分の限界なんてないと…	強がりかもしれない、でもやっぱり
今日に負けずに	伸ばす背すじ
何度でも　何度でも	傷付いても　走っていくよ
傷付いても　走っていくよ	涙　光　強さを
本当は辛い時	本当は抱きしめて欲しい
でも強くありたい	自分の力を今日も求めてるから
強がりかもしれない、でもやっぱり	全ては見せたくない
本当は泣きたい	でも強くありたい
言えないよ(言えないよ)	「大丈夫」
自分がエネミー	今日に負けずに
一人じゃないから	私がキミを守るから
私がキミを守るから	あなたの笑う顔が見たいと思うから
言葉にならないほどの想いを	どれだけアナタに伝えられるだろう….
孤独じゃ重い扉も	共に立ち上がればまた動き始める
どれだけのコトが出来るのだろう…	言葉にならないほどの想いを
だからずっと、ずっと	あきらめないで….
今　私が笑えるのは	一緒に泣いてくれたキミがいたから
一人じゃないから	キミが私を守るから
あなたの笑う顔が見たいと思うから	時がなだめてく
強くなれる　もう何も恐くないヨ….	時がなだめてく
説明する言葉も	ムリして笑うコトもしなくていいから
何かあるなら　いつでも頼ってほしい	疲れた時は　肩をかすから
どんなに強がっても	ため息くらいする時もある
限られた時の中で	どれだけのコトが出来るのだろう…
ムリして笑うコトもしなくていいから	何かあるなら　いつでも頼ってほしい
時がなだめてく	痛みと共に流れてく
痛みと共に流れてく	日の光がやさしく照らしてくれる
ずっと閉じ込めてた	胸の痛みを消してくれた
作りながら生きてくの	だからずっと、ずっと
胸の痛みを消してくれた	今　私が笑えるのは
ため息くらいする時もある	孤独じゃ重い扉も
時に人は傷付き、傷付けながら	染まる色はそれぞれ違うケド
キミが私を守るから	強くなれる　もう何も恐くないヨ….
言葉にしなきゃ	分からないときもあるから
ひとりだけ	こんな気持ちなんて…
(期待したくない)	勘違いしたくないから
近づきたくても見えない	聞かせて
心振りまわされても	キミの笑顔を見れば
(願うことばかり)	私は大丈夫だと
(傷つきたくない)	でも何も教えてはくれない
約束なんか要らないもう	(期待したくない)
あなたといたい	キミの理想に
この関係こわさないように	(傷つきたくない)
いつも	心振りまわされても
キミの理想に	近づきたくても見えない
全てがうまくいくようにと	(願うことばかり)
私は大丈夫だと	言いきかす
言いきかす	この関係こわさないように
キミの笑顔を見れば	忘れてしまうつらさ
教えてよ	本当の気持ちを
勘違いしたくないから	やさしくしないで
共に描く人間の愛　進歩て	姿見えなくても会えなくても
行き詰めった時は　いつもそばにいてくれた	意味詰まった　言葉で教えてくれた
思い出じゃく　現在進行形	共に描く人間の愛　進歩て
どれくらいの 時間が過ぎたのかナ?	気づかないほど うれしくて
オヤスミって ただ伝えたくて	夢で会えるように…
もしも 願いが叶うのならば 時間を止めて	いつもの調子で 離れたくない
声がもう1度聞きたくて	オヤスミって ただ伝えたくて
くもったガラスふいてみる	マドの向こうに雪がちる ただ外を見つめ…
ケイタイの音 いつもの調子で	いつもの声で 名前を呼んで いつもの声で
眠りかけてた頃に 鳴り響く	ケイタイの音 いつもの調子で
いつもの調子で 離れたくない	また会えるの 分かってるケド…
帰るそばから 会いたくて	声がもう1度聞きたくて
あなたが笑顔でいるだけで	出来る気がするよ　何だって
疲れもグッバイ	不思議なくらい
あと少しだけ　あきらめないでいて	もうすぐ来るから　幸せな時間が
どうしようもない一日	(もう全てを投げ出したい)
たまには自分や、仲間にもごほーび	さぁみんなでもりあがろう!
出来る気がするよ　何だって	君と一緒なら
耳を澄ませば聞こえる　笑い声が	そーだね　考えすぎずに気軽に行こうっ!!
弱気な自分や	不安やイライラ
不安やイライラ	どうしようもない一日
ローからハイ	疲れもグッバイ
みんなでもりあがろう	もりあがろう
今にも泣きそう	でも今までだって乗り越えたんだ
みんないろんな悩みを抱えて	それぞれの一日を過ごしてる
(もう全てを投げ出したい)	今にも泣きそう
なんで私だけって	そう思ってた
忘れかけてた	大切なものを
がんばる人の姿	自分の中でとまってた
余裕がなくて	見えてなかった
自分の中でとまってた	何かがまた動き出した
一緒に笑いあう日も	一緒に流す涙も
毎日がもう疲れてた	なんで私だけって
見えてなかった	気づけなかった
同じ時間を　過ごしてた	余裕がなくて
心の底から	嘘じゃないって言える
何も言わずに　支えてた	同じ時間を　過ごしてた
それでも	君は変わらぬまま
君に出会うまで	わからなかったけど
人を思いやる気持ち	どこかに閉じ込めてたけど
一緒に流す涙も	心の底から
周りを見渡せば近くで	がんばる人の姿
君は変わらぬまま	いつでも　笑ってくれた
そう思ってた	君に出会うまで
大切なものを	あなたがくれた優しさを抱いて
嘘じゃないって言える	想いは伝わるから
教えてくれた　その瞳が	忘れかけてた
いつでも　笑ってくれた	人を思いやる気持ち
ため息をつく事ばかり	毎日がもう疲れてた
気づけなかった	人のせいにして
思うようにいかない	毎日がただ過ぎてく
季節は巡って　その度に泣いて、笑って	“飛び越えていけるこの山も”
チャンスをつかもう	今、この手で!!
振り返れば誰かが　いつも支えてくれてた	“乗り越えていける一緒なら”
毎日がただ過ぎてく	繰り返し不安に
なつかしい写真を見てると	あなたがくれた言葉を思い出して…
繰り返し不安に	のみ込まれそうになってく
“乗り越えていける一緒なら”	そう信じて進む
“飛び越えていけるこの山も”	そう信じて進む
ケイタイに保存してた	なつかしい写真を見てると
お喋り…　お喋り…	必要無いよ　今は
この瞬間を　この瞬間を	追いかけ続けて
夜道を弄れど虚しい	改札の安蛍光灯は
味わう如く季節を呼び起こす	あたしが望んだこと自体矛盾を優に越えて
改札の安蛍光灯は	貴方の影すら落とさない
一番愛しいあなたの声迄	掠れさせていたのだろう
今日も又足の踏場は無い	小部屋が孤独を甘やかす
愛している	独り泣き喚いて
歪んだ無常の遠き日もセヴンスターの香り	味わう如く季節を呼び起こす
確信出来る現在だけ重ねて」	「あたしの名前をちゃんと呼んで体を触って
頬を刺す朝の山手通り	煙草の空き箱を捨てる
独り泣き喚いて	夜道を弄れど虚しい
あたしが望んだこと自体矛盾を優に越えて	一番愛しいあなたの声迄
「あたしの名前をちゃんと呼んで体を触って	必要なのはこれだけ認めて」
「不穏な悲鳴を愛さないで未来など見ないで	確信出来る現在だけ重ねて」
煙草の空き箱を捨てる	今日も又足の踏場は無い
静寂を破るドイツ車とパトカー	サイレン爆音現実界　或る浮遊
寂しいなんて言えない	でも気付いて欲しい
止まらないし止められない誰にも　今しか無いんだから	遊びだって夢へとつながる　そんな感じのバイプレーション
何が起きるか分からない今日も　朝まで行っちゃうでしょ	止まらないし止められない誰にも　今しか無いんだから
たまにはいいじゃない	行き先決めずに　気ままに
裸足のまま夢の中へ	ここから抜け出して
余裕がない　わりに刺激もない	(同じ毎日は)　別に問題ない　
いつものように	夢見る　ファンタジー
始まりはそういつもここから	今日も走りぬくの　このまま
なんかちょっとこれって	もしかしてネグレクト?
バカみたいじゃん	もしもしは無視無視で
もしもしは無視無視で	どうしてどうしてもなしで
あ〜あぁ　あ〜あぁ	あ〜もうやだ
くだらない話でいいなら	きかせるよ
今日もまた誰かがキズついてキズつけて…	そんなこと繰り返すのはもう終わらせたい
叫んでも、遠すぎて…	でもあなたの声はきこえるよ
手を伸ばして	きっと届くから
あなたが	眠れるまで
今夜もこの街のどこかに君がいて	叫んでも、遠すぎて…
きかせるよ	いつでも
覚えていて	くだらない話でいいなら
でもあなたの声はきこえるよ	手を伸ばして
心配なんていらない	ここにいるよ
いつでも	心配なんていらない
ここにいるよ	あなたが眠れるまで…
大丈夫なんて気安く言えないよ	だけど君の不安や孤独を溶かしたい
いつでも	きかせるよ
いつでも	あなたが
笑い方さえも　忘れてる…	今のアナタの　顔を
アナタがつくるの!!	「誰も信じられない…」
逃げるコトじゃなくて	ちゃんと自分と向き合って
憎しみなんかいらない	みんな一緒に手放せばいい…
繰り返させるの?	笑い方さえも　忘れてる…
何度　同じコト	繰り返させるの?
今すぐに目を　覚まして!!	見えるキズも　心のキズも
見えるキズも　心のキズも	いらない　アナタには必要ない
なんて　人　恐れないで	そのカラさえも　やぶれるはず
そのカラさえも　やぶれるはず	この世に武器ある限り
「誰も信じられない…」	なんて　人　恐れないで
素直になれる	そんな場所が待っている
出会えばきっと	誰もが　笑顔になれる
出会いや別れ　驚きや感動	きっと全てが　思い出に変わる
いつもと違う朝　いつもと違う道	いつもと違う君　今日は特別な日
幸せに溢れる時間を	胸に抱きしめて
恋人達も　家族も　友達も	みんなが温かい幸せ感じられる
今年も一緒に　いれたらいいな	キレイな星の下で　最高の
きっと自然に惹かれ合っていく	キラキラ光るイルミネーションの中へ
近づけば　近づくほど	何だか胸が熱くなる
胸に抱きしめて	楽しもうネ　クリスマス
トキメキ　喜び　幸せ	全てが降りそそぐ　そんな　特別な日
街中に広がる屋台	通り過ぎると温かい
何もかもが　どうでも良くなるくらいに	打ち上げよう　その花火を
光っては消えてく	みんな同じように
人ゴミにただ　まぎれたい	この景色は変わらない
心が癒される場所	1つくらい確保したい
瞬きする瞬間	光っては消えてく
悩みを燃やして	明日の空を見上げて
打ち上げよう　その花火を	何もかもが　どうでも良くなるくらいに
その火を灯して	悩みを燃やして
明日の空を見上げて	その火を灯して
打ち上げよう　その花火を	打ち上げよう　その花火を
1つくらい確保したい	みんなの安らぐ場所は
みんなの安らぐ場所は	どこにあるのかな…
今の自分も毎日も	大事にしよう
通り過ぎると温かい	人ゴミにただ　まぎれたい
君が笑えば　この世界中に	もっと　もっと　幸せが広がる
本当は溢れてる　たくさんの笑顔が	ほら　こっち向いて
もっと　もっと　幸せが広がる	君が笑えば　すべてが良くなる
でも　1人になったとき	なんか分かった気がした
本当に君に　会えて良かった	どんなに嫌な1日だって　君の笑顔で
余裕がなくて　優しくなれない	そんな時でも　ちゃんと分かってくれている人がいる
どんなに嫌な1日だって　君の笑顔で	最高になっちゃう　この星降る夜も
最高になっちゃう　この星降る夜も	一緒に眺めていたい
特別だとか　思ってなかった	でも　1人になったとき
なんか分かった気がした	一緒にいれることの幸せ
街中が　光に包まれてく	君の所にも届いて欲しい
君と過ごしている時間を	特別だとか　思ってなかった
君が笑えば　すべてが良くなる	この手で　その手で　つながる
踏み込んでみりゃえぇに　新天地どこ？	その為にゃ助走　始まりはここ
時が経って　年取ったって	諦めたくない　情熱は消えない
そんなに私の 話がつまらない?!	…だけど焦らず ゆっくり こっち向かせる
あなたはどうして　向こうを見てるの?	そんなに私の 話がつまらない?!
…だけど焦らず ゆっくり こっち向かせる	感情出さずに イイ女でいたいから
何度も「大丈夫…」 言い聞かすケド	やっぱり寂しい 1人の夜
電話の向こうで聞こえてくる　女の子の声　気にしないフリして	罪悪感感じてないアイツだから　何も言えなくて　だけどくやしくて
駆け引きなんかじゃない	このまま居させてよ
たまにはいいんじゃない　邪魔はされたくない	自分へのご褒美だって思えばいい
このまま居させてよ	みんなと自由に楽しみたいだけなの
自分へのご褒美だって思えばいい	たまにはこんな時間も必要だから
もう少し　分かってよ	この気持ち　押さえきれないから
みんな 無我夢中になってく	熱くさせてくれる
着信してる　メロディー聞いて	うれしい予感すれば　誘いの声
ドキドキ　また　かけめぐる	魔法かけられたような気分になって
100％恋してる	目にヤきついた　彼(ひと)に酔いしれる
こっちは常に出してる100％!!	ケド　最近の私やっぱ　何かヘン…
100％恋してる	もうすぐ　会えるまで　あと15分!
ドキドキ　まだ残ってる…	こんなに想える人　今までいなかった
久々にあなたの　香りとしぐさで	ドキドキ　また　かけめぐる
となりで　あなたの声聞いて	一緒にいられるなんて　信じられない
もうすぐ　会えるまで　あと15分!	急いで　飛ばして　彼のトコまで
アセる気持ち　限界まで来てる	ここからが勝負　胸のどこかで…
一緒にいられるなんて　信じられない	偶然の出会いから　こんな風に
100％恋してる	会えない分だけ　会いたくなる
100％恋してる	アセる気持ち　限界まで来てる
目にヤきついた　彼(ひと)に酔いしれる	会えば会うほど　キミに惹かれてく
今日もまた　彼の夢見て　目覚めちゃった	ドキドキ　まだ残ってる…
あぁ　肌に感じてたい この自由を	あぁ　今が終わって欲しくない
全部　吹き飛ばしてあげる	もう泣かないで　アナタの声は
今までずっと分からなかった	アナタがくれた　信じる力
守るものがあるから　生きていける	キミの痛みも　どんな悩みも
ただヒザかかえ　うずくまってた	不安と孤独おそう　この場所から
不安と孤独おそう　この場所から	やさしく手にぎって　連れ出してくれた
暗闇の中で　名前を呼ぶ方へ	向かっても　何も見えないとき
守るものがあるから　強くなれる	どんな痛みも　どんな悩みも
どんな痛みも　どんな悩みも	きっと受け入れられる
アナタがくれた　信じる力	この願いも届く気がする
キミの痛みも　どんな悩みも	全部　吹き飛ばしてあげる
どこか遠くで声がきこえる	暗闇の中で　名前を呼ぶ方へ
向かっても　何も見えないとき	ただヒザかかえ　うずくまってた
両手をあわせ　ただ祈ってた	人は傷つくコトもあるけれど
光のさしこむ方へと　一緒に歩こう	守るものがあるから　生きていける
もしもアナタが弱ってる時は	かわりに私が強くなるから　心配いらないよ
きっと受け入れられる	だから大丈夫　アナタの声はきこえてるから
この願いも届く気がする	両手をあわせ　ただ祈ってた
人は傷つくコトもあるけれど	すぐにまた笑えるトキが来るから
全部　吹き飛ばしてあげる	もう泣かないで　アナタの声はきこえてる
光のさしこむ方へと　今　歩き出す	守るものがあるから　強くなれる
こんな毎日でいいのかな?と…(今すぐ)	憎しみや悲しみも
幸せになるために	こんな毎日でいいのかな?と…(今すぐ)
ヒマすぎて　忙しすぎて	時々こわれそうになるケド　(今すぐ)
憎しみや悲しみも	吹き飛ばして
気になるのに聞けない	泳ぎつかれて君まで無口になる
会いたいのに見えない波に押されて	また少し遠くなる
無理はしない主義でも	少しならしてみてもいいよ
ひとことでこんなにも傷つく君は	孤独を教えてくれる
無理はしない主義でも	君とならしてみてもいいよ
誰にも止められない	体に(ひびく)　リズムに(ゆれる)
誰にも止められない	頭の中に焼きつくメロディー
体に(ひびく)　リズムに(ゆれる)	炎のように熱く
目覚めたように	炎のように熱く
頭の中に焼きつくメロディー	炎のように熱く
思い出をめくるたび	あなたの手をつないでた…。
流れてく	思い出をめくるたび
だけど強がった分だけ	素直になれなくて
形のない何かで 教えてくれる	どんなに大人になっても
どんなに頑張っても…	何もうまくいかなくて
溢れ出す想いを	包んでくれたから
溢れてく	流れてく
焦ってかけ込む日々	どんなに頑張っても…
1人でいたくなくて…	あなたに聞いて欲しい…ほんの少し
アルバムの中のあなたは	果てしない あの空のように
雨が降ってきた少し	焦ってかけ込む日々
素直になれなくて	いつでもゴメンネ…って言えなくて…
果てしない あの空のように	形のない何かで 教えてくれる
涙が	溢れ出す想いを
いつも変わらずあなたの愛だけは心に	いつも変わらずあなたは太陽のように…
「何にも言わなくても	ちゃんと分かってるよ!」
ちゃんと分かってるよ!」	とあなたは笑顔で
いつも変わらずあなたの愛だけは心に	いつも変わらずあなたは太陽のように
何もうまくいかなくて	1人でいたくなくて…
とあなたは笑顔で	だけど強がった分だけ
やさしさで	涙が
本当の優しさと心地よさ	離したくない
大きな円で私たちはつながっている	何処にいても感じれば近い
何もかも解き放って	私は生まれ変わる
私は生まれ変わる	この瞬間　この感触を探してた
答えはあなただけが　知っている	それでいい
今を自由に	感じるままに
久しぶりにキミに	会えるすごく嬉しい!!
夢ひとつ　叶えられる	そんな気がする
待ちきれなくて	胸が弾んでる!!
いつものように笑って	その笑顔ひとつで
どんなに疲れてても　あなたに	会うと不思議と元気になる
その笑顔ひとつで	迷いも不安も消してくれる
胸が弾んでる!!	久しぶりにキミに
何も求めないなんて	言えばウソになるケド
アナタにとって	安心できる場所でいたいから
同じ景色の中で	そのキズが癒えるまで
もしもいつか会えなくなるのなら	今の気持ち伝えたいから…
人混みにまぎれながら	足下を気にしてただ押される…
足下を気にしてただ押される…	行き先も止まったままで
今の気持ち伝えたいから…	アナタにとって
どうしようもない風や	雨に打たれた時は
同じ太陽の下で	同じ景色の中で
雨に打たれた時は	遠慮しないで
つぶやく胸の中でゆっくり、ゆっくりと	強くなる想いは
何を言えばいい?	この気持ちで迷わせたくないから
(怪しすぎるでしょ!?)	すぐにかけ直すって そっから10 時間
アイツとはもう懲り懲り	次のステップに1,2,3
すぐにかけ直すって そっから10 時間	バカにしてるとしか思えない!!
次のステップに1,2,3	(そう!) それくらいがちょうどイイ
ありのままの姿で良かった	でも違ってた…
手に入れたい…(いつか叶えたい)	ありのままの姿で良かった
大空へ	この歌にのせて
この歌にのせて	運んでくよ
愛する　君に　君に　君に	贈るよ　君に　君に　君に
アナタに出会えて	私は変われたから
届いてもっと	この想いを
運んでくよ	アナタの元へ
アナタの元へ	どんなに離れてても
贈るよ　君に　君に　君に	この歌を
アナタにもっと	届いてもっと
アナタに出会えたおかげで	世界が変わったから
私達は　つながってるから	忘れないでね
私は変われたから	アナタに出会えたおかげで
どんなに離れてても	私達は　つながってるから
こんなんじゃ続かない...	信じれないならもういいよっ!!
でも何か足りない	このまま帰りたくない...
一目惚れ...!? いや、彼がいるから	もっと早くに出会えてたら
このまま帰りたくない...	もっと楽しませて
音の中でもっと近づこう	一目惚れ...!? いや、彼がいるから
君を守れるようになれるように	もう二度と君を悲しませない
君を守れるようになれるように	もう二度と君をキズつけない
人のせいにして　ヒロイン演じてた	何やってたんだろう
あなたに出会うまで	暗闇の中から出れずにいた
自分のことをもっと愛そう	私は今　何も怖くない
私は今　何も怖くない	もう二度と自分をキズつけない
そっと太陽が顔に触れた朝	久しぶりに生きた気がした
久しぶりに生きた気がした	なんだか嬉しくて
分かってはいたけど	負のサイクルから抜け出せない
自分のせいで	全てが上手くいかなくなったのに
ここから始まる　ゼロから始める	自分のことをもっと愛そう
なんだか嬉しくて	涙が止まらない
全てが上手くいかなくなったのに	人のせいにして　ヒロイン演じてた
涙が止まらない	負のサイクルから抜け出せば
このままじゃいけないと	分かってはいたけど
自分の中にも	取り込もう
試したいことはいっぱい	まだまだまだ
どんどんイイもの	集めて!!
取り込もう	どんどんイイもの
広い世界	見てみたい
いつだってそう!!	少しずつ上がってこう
周りにインスパイヤー	されることばっか
やってみないとわかんない	試したいことはいっぱい
目を見開けば	周りにインスパイヤー
休むヒマはない	だけど焦らない
「ここからが勝負。」	いつだってそう!!
ため息よりも	深呼吸しようよ
時間だけは	止まらないから
忘れちゃうぐらいの	喜びもたくさんあるから
ちょっと　切ない時とか	ため息よりも
どんなコトだって	あなた次第で
あなた次第で	変えてけるの
ずっとずっと	走り続けたって　どこかで
ちょっと　悔しい時とか	いつもより
走り続けたって　どこかで	立ち止まって
楽しいコト	ばかりじゃないよね
いつもより	ちょっと　寂しい時とか
ちょっと　寂しい時とか	いつもより
大きく息を吸って	明日になれば
明日になれば	胸の痛み　消えるから
いつもより	ちょっと　悔しい時とか
そんなコト	忘れちゃうぐらいの
ばかりじゃないよね	苦しくて
両手広げて	大きく息を吸って
苦しくて	泣きたい日も　あるケド
我慢しないで	全部外に出そうよ
いい明日にしよう	だから
いつもより	ちょっと　泣きたい時とか
泣きたい日も　あるケド	そんなコト
いつもより	ちょっと　切ない時とか
深呼吸しようよ	いつもより
ちょっと　泣きたい時とか	我慢しないで
今更くだらない　ゲームなんてやめて	ハスラーきどりで　テキトーな子と
だいたいアイツには　彼女がいたし	でも最近の私は　どうかしちゃってる
ジャジャ馬おてんば　だが脇あめーんだな	見極めんだな路上で弾けるサイ
路開けなじょうちゃん　ヒマじゃねえんだ	悪い冗談　ガラじゃねえんだ　頼むぜ
でも最近の私は　どうかしちゃってる	口開けばいつも　キミの事ばかり
悪い冗談　ガラじゃねえんだ　頼むぜ	どこ見たってアンバランスな2人
ハスラーきどりで　テキトーな子と	上辺だけの話して　モテてるふりして
ぶっ放すプラチナの弾丸　喰らっちまっちゃ最後　あきらめんだな	ジャジャ馬おてんば　だが脇あめーんだな
タイプじゃないし　眼中なかったし	だいたいアイツには　彼女がいたし
ガキはシッシッ　おねんねの時間帰んな	やさぐれた若ダンナ　触んなキケンだ
生まれてきてくれて	本当にありがとうね
愛しすぎて	ずっと待っていたよ
あなたが生まれた　あの瞬間から	私の全てが変わった
言葉にできないよ　この感情	愛しすぎて
そう　思い出して　あなたのこといつも	愛している　人がいることを
私の全てが変わった	言葉にできないよ　この感情
あなたがいつか　大きくなった時	鏡を見て　笑えない時は
鏡を見て　笑えない時は	そう　思い出して　あなたのこといつも
もしもあなたが　孤独な時も	この歌が支えてるから
ずっと大事にしてた　このちょっとした勇気で	いつかは私たちにも　誰かを支えられるはず
誰だって同じように　いつでも不安を抱いてる	全てはすぐに消せないけれど　少しずつ進めば
みんながあなたみたいに　強くなれたらと思ってた	未来を見てるあなたに　何をしてあげられるんだろう
きっと今初めて　もう一歩踏み出す時	我慢なんてしないでもいい　今度は私が支えるから
ワレワレハ	ワレワレハって誰だ？　誰だっけな
愛される性格だけど	頑張り過ぎたり
今でも何かあると	あなただったら
でもホントは寂しがり屋で	話したいことも沢山あるでしょ？
どんなに会えなくなっても	私は変わらず　ここにいる
あなたはみんなに	愛される性格だけど
なんて言うんだろうとか	そばにいなくても励ましてくれる
時が経っても私たちは	ずっと変わらずつながってる
もしあなたが道に迷い	すべてが嫌になったとしても
さよならなんて言わなくていい	だって寂しすぎるから涙は堪えて
あなたの場所があるから	いつでもあなたに
いつでもここに	あなたの場所があるから
頑張り過ぎたり	頑固なとこあるから
どうしただろうとか	なんて言うんだろうとか
あなたと生きてる	いつまでも　ずっと
いつでもあなたに	助けられてきたから
人に言えないで　強がってばっかで	でもホントは寂しがり屋で
そばにいなくても励ましてくれる	もしあなたが道に迷い
助けられてきたから	遠くに離れても
頑固なとこあるから	人に言えないで　強がってばっかで
だって寂しすぎるから涙は堪えて	笑った顔で送り出したいから
あなただったら	どうしただろうとか
遠くに離れても	どんなに会えなくなっても
今　この世界へ	暗闇を抜けて
このままじゃ良くない	そうでしょ？
素直になればいいのに	仮面をかぶってる
このキケンなゲームも	終わらせたい　でも止まらない
愛を広げて	今　この世界へ
貴方の為に　優しくなってく	でも　また傷付くのが怖くて
例え言葉で通じなくても	話し合えばいいのに　心で
不安も　孤独も	憎しみも　悲しみも
いつも愛が足りてない	どこまで続くの
今日も誰かが	誰かのせいにしてる
愛　愛　愛　愛があれば	愛　愛　愛
誰かのせいにしてる	素直になればいいのに
終わらせたい　でも止まらない	このままじゃ良くない
いつもあとから付いて来る	矛盾と言い訳
喧嘩も止めて	仲良くすればいいのに
その矢を放てるの？	相手の立場になって　考えればいい
暗闇を抜けて	あの太陽のように
また　歩き出せるようになってく	貴方の為に　優しくなってく
仮面をかぶってる	私のせい　君のせい
愛　愛　愛　愛があれば	愛　愛　愛　愛
そうでしょ？	ねぇ　そうでしょ？
仲良くすればいいのに	みんなが幸せになればいいのに
変わらないこの世界	いつも愛が足りてない
信じたい　でもまだ迷ってる	壊れたハート元に戻してる
互いに　愛があれば	愛　愛　愛　愛があれば
みんなが幸せになればいいのに	そうでしょ？
話し合えばいいのに　心で	いつもあとから付いて来る
憎しみも　悲しみも	喧嘩も止めて
もう過去には戻れない　でも	あなたは変えられる　未来を
私のせい　君のせい	そんなこと　どーでもいい
相手の立場になって　考えればいい	そうでしょ？
愛　愛　愛　愛があれば	互いに　愛があれば
もっと	愛　愛　愛　愛があれば
どこまで続くの	このキケンなゲームも
一人でも　同じように	その矢を放てるの？
振り絞るように声を上げて	伝えようとしたことも
うずくまるその背には	何を背負っているの
少し似ているのかな	平気な顔して過ごす日々にも
どうして今君は	ひとり泣いてたの
伝えようとしたことも	あなたには全て
平気な顔して過ごす日々にも	慣れた気がしてたけど
強がって笑った今の僕に	少し似ているのかな
あなたを待つ場所	あなたが待つ場所
あなたが待つ場所	絆が待つ場所
はじめからそう	わかってしまうから
あなたには全て	はじめからそう
ひとり泣いてたの	うずくまるその背には
食事に映画に　時には2人旅	くだらないケンカに
あの頃はいつも長電話したり	いつまで経っても
テレビ観て　感動のシーン	一緒に泣いて笑い
いつまで経っても	そんな気持ちでたいね　ずっと…
お互いの家を行ったり来たり	あの頃はいつも長電話したり
一緒に泣いて笑い	あふれる想いで　たくさんの思い出
ごまかさないように	自分の足で立てるように
風が吹く「大丈夫だよ…」と	ささやくように…
現実が辛くても	ごまかさないように
時が過ぎて変わり果てたケド	風が吹く　やさしく包む
思い出ばかりが映る	アルバムをめくるたびに
あって当たり前だと…	どんなに古くても
あの景色はもう見れないまま…	思い出ばかりが映る
季節変わっても	またすぐに来るケド
代わりなど　どこにもない	時が過ぎて変わり果てたケド
またすぐに来るケド	あの景色はもう見れないまま…
風が吹く　やさしく包む	なぐさめるように…
自分の足で立てるように	「前を見て進むんだ」と
出会えたコトから	今の自分が生きてる
何か起きたら飛んで行くよ	少しだけ大人になった時
少しだけ大人になった時	2人また笑顔で会えますように…
1年前が昨日のように思えてくる毎日が	続いて私に語りかける
時が経つのは早すぎて	1年前が昨日のように思えてくる毎日が
言葉じゃ伝えきれない	想いも分かり合える
写真見ながら問いかける	数々の思い出よみがえる
今の自分が生きてる	これからも会えなくても
約束とかはしないでも	いつかまたすぐ会える気がするから
私は私でやってゆくよ	少しだけ大人になった時
季節と一緒に変わってこう	お互いの夢に近づいていけるように
今だけは会えなくても	私は私でやってゆくよ
数々の思い出よみがえる	離れていてもいつでも
離れていてもいつでも	そのまっすぐな瞳　見守っているよ
想いも分かり合える	今だけは会えなくても
やるべきコトをやってきてよ	何も心配はいらないから
これからも会えなくても	何か起きたら飛んで行くよ
少しだけ大人になった時	2人もっと成長して会えるといいネ…
いつだって僕らは	つながってるんだから
笑わせてあげるから	作ってあげる　温かいご飯
あなたがいる時はいつも	夜更かししたくなる(いつも)
作ってあげる　温かいご飯	それともみんなで　お祭りとか?!
元気ない時	こっちにおいで
こっちにおいで	笑わせてあげるから
お別れがちょっと寂しいケド…	(またおいでね!)
あなたがいれば	何だって楽しい
一緒にいた分だけ	お別れがちょっと寂しいケド…
雨が降ってたって	晴れてたって
いつでも　君を待ってるよ	もっと見せたいよ
ここにおいでよ	いつでも　君を待ってるよ
(またおいでね!)	どんなに離れてても
あなたを連れて行きたい	あなたの笑顔が見たい
すぐにまた会えるから	いつだって僕らは
それともみんなで　お祭りとか?!	いつだって　待ってるから
寂しい時	元気ない時
笑わせてくれるから	一緒にいた分だけ
あなたの笑顔が見たい	一緒に作ろう　たくさんの思い出を
晴れてたって	あなたがいれば
いつだって　待ってるから	あなたを連れて行きたい
どんなに離れてても	すぐにまた会えるから
もっと見せたいよ	いろんな　素敵な場所を
世界で一番厳しくて	世界で一番優しい人
あの頃は生意気に	早く一人になりたいと
理由も知らないくせに	いつも一緒に泣いてくれてた
でも結局あなたが居ないと	何も出来なかった　寂しかった
世界で一番優しい人	理由も知らないくせに
ママ　あなたが教えてくれた	優しさ　思いやり　愛を
何度も何度も	迷惑かけた
早く一人になりたいと	でも結局あなたが居ないと
どうしたら伝わるのか	考えてる間にも　時が経ってく
いつもありがとう	ママ　あなたが教えてくれた
未来の私は	あなたのようになれてるかな？
優しさ　思いやり　愛を	ママ　あなたが見せてくれた
ママ　生んでくれて感謝してるよ	いつもありがとう
ケンカしても　言いあっても	どんなに離れてても
何も出来なかった　寂しかった	それだけ沢山の　愛をくれてたから
ありがとうも　物足りないくらい	どうしたら伝わるのか
迷惑かけた	それでも私を愛してくれた
何も変わらない　あなたには一生かなわない	ウチは他の家とはちょっと違うけど
どんなに離れてても	何も変わらない　あなたには一生かなわない
ママ　あなたが見せてくれた	希望も　未来も　全てを
何を言っても　言い足りない	ありがとうも　物足りないくらい
ウチは他の家とはちょっと違うけど	あなたの子供で　本当に幸せだよ
それでも私を愛してくれた	未来の私は
心の隙間をうめてくれてたのは	いつだって　そう…
心の中で響いてた　何も聞こえないように	耳をふさいでたあの頃の　キズつかないように
音楽があれば　自然と瞳を閉じてた	やさしく包んでくれてた
迷いながら　探し求めてたのは	いつもそばにあった　背中押してくれてた
耳をふさいでたあの頃の　キズつかないように	人を疑ってばかりだった私を　救ってくれた
いつもそばにあった　背中押してくれてた	心の中で響いてた　何も聞こえないように
生きる希望　喜び　教えてくれた	諦めないでって　命をくれた　音楽が
5年後も10年後も　この先ずっと	光輝く音の中で過ごしていたい
終わらない死ぬまでずっと	もう先に何も見えない
光輝く音の中で過ごしていたい	生きる希望　喜び　教えてくれた
もう先に何も見えない	そんな日が来ても私は歌を歌っているだろう
それでも歌っている間は忘れてられた	痛くても　傷ついても　乗り越えなくちゃ
痛くても　傷ついても　乗り越えなくちゃ	きっと大丈夫　そう思わせてくれる　音楽が
苦しい時　哀しい時　沢山あった	それでも歌っている間は忘れてられた
この想いはいつまでも	終わらない死ぬまでずっと
さりげない音の音(ね)に	胸の中がざわめき出す
届けばいいなと	この想いはいつまでも
「そう現実は 甘くない」とか	そんなコト分かってるケド
諦めはしない そう決めたから…!!	何があっても 振り向きはしない
「どこにもいないような人になりたい」って言えば	キミは笑うケド 私は本気だよ 何も恐くない
どこまでいけば認めてくれるの?	あなたにも分かって欲しい…
夢は夢じゃない 叶わせるから	諦めはしない そう決めたから…!!
叶わなくても 後悔はしない	信じていく 輝く未来
私の未来 自分で決めたい	私の人生 迷わない
このままずっとこうしているのもイイケド…	どこまでいけば認めてくれるの?
あなたにも分かって欲しい…	ムリならしょうがないケド…
今でも変わらず私の中で	光りつづけてる
何があっても 振り向きはしない	たどりつける いつの日か!!
今でも変わらず私の中で	燃えつづけてる
あきらめないで	私もあきらめないよ
でも力を合わせれば	何だってできる
この手を離さないで	その手を離さないで
ゆっくり　ゆっくり歩いてけばいい	時間がかかっても
愛をもって　人に触れたい	愛をもって　感じ合いたい
目の前の自分も	ちゃんと愛せるようになろう
泣きたい時もある　くやしい時もある	でも周りを見渡せば
勇気を出して　飛び出そう	愛をもって　人に触れたい
私もあきらめないよ	明日をあきらめないで
未来のドアを開けよう	勇気を出して　飛び出そう
分かり合えない時もある	でも力を合わせれば
新しい毎日を　大切に過ごそう	目の前の自分も
少しずつ　少しずつ歩いてけばいい	ゆっくり　ゆっくり歩いてけばいい
何だってできる	奇跡も起こせる
時間がかかっても	私は信じて進む
ぶつかり合うこともある	分かり合えない時もある
でも周りを見渡せば	支えてくれる　仲間がいる
私は信じて進む	この手を離さないで
明日をあきらめないで	進んでゆこう
休んでは　休んで	泣いて　笑って　飯食って
空見れば　星がある	夢見れば　虹がでる
雨の日もある　風の日もある	たまに晴れたらまるもうけ
いいことがない　うまくいかない	それでもお腹はへってくる
走って　転んで　寝そべって	あたらしい明日が待っている
忘れては　悩んで	あした　あさって　しあさって
特別じゃない　英雄じゃない	みんなの上には空がある
悩んでは　忘れて	忘れては　悩んで
誰も　彼も　どんな人も	あたらしい世界をもっている
向かい風でも　つむじ風でも	寝転んでしまえばそよ風
走っては　休んで	休んでは　休んで
ラランララン…	ラランララン…
振り向けば　君がいる	前向けば　友がいる
あした　あさって　しあさって	あたらしい未来がやってくる
泣いて　笑って　飯食って	あたらしい自分になってゆく
前向けば　友がいる	走って　転んで　寝そべって
夢見れば　虹がでる	誰も　彼も　どんな人も
どんなにアセっても進まなくなるトキもある	そんな時言い聞かす
音楽の中で!!!	今を止めないで
やらなきゃいけないことだらけ	でもどうせなら楽しみたい
さぁ踊ろう(踊ろう)　手本はいらない	今はただ 　楽しみたいだけ
ボトル持って　(カンパーイ!)	もっと踊って　(止まらない!)
もっと踊って　(止まらない!)	もっと踊って　(終わらない!)
人生は　一度だけ	やらなきゃいけないことだらけ
せめてそれだけでも	自分を愛せるから　私は負けない
だから諦めなかった	そして　今も
もうこれ以上	無理だと思った
何度でも	立ち上がれる
でも諦めなかった	そして　今も
立ち上がれる	自分のこと信じてゆく
どこまで走れば届くのだろう	私の夢まで　教えて
思い出す　君との約束は	いつまでも途切れない
私の夢まで　教えて	あとどれぐらい?
そして　今も	せめてそれだけでも
いつまでも途切れない	今でもこの手の中に
無理だと思った	何度も…
でも　夢で終わらせない	「いつか必ず」って信じて
冷たい視線　上がる体温	吹き飛ばす　プレッシャー
その笑顔に	何度救われただろう
あぁ毎日が(毎日が)	何のために？(誰のために？)って
こぼれそうな想い　押さえて…	こっちまで　泣きたくて
キミはムリして笑って	「周りだけが加速してく中で
どんな時でも	私にとってキミは
何のために？(誰のために？)って	思うトキもあるかもしれない
あきらめないコト	教えてくれたキミが
いつも期待どおりになるワケじゃない	恋愛　仕事　遊びも
「周りだけが加速してく中で	自分だけが…」って
私の目に映るキミは	そう　とても　輝いてみえる
自分だけが…」って	くやしそうに　上を向いて
どんな人でも、	いつも期待どおりになるワケじゃない
思うトキもあるかもしれない	だケドね
何度救われただろう	どんな時でも
くやしそうに　上を向いて	こぼれそうな想い　押さえて…
□不到終點　汗滴○視線　念頭多清楚	我們都看見　愛能多句跨越　不同顏色的皮膚
我們比誰都清楚　別再相互的抵觸	我們用愛來體悟　痛徹心扉的領悟
讓我們擁抱彼此不管夜或是那白晝	別讓自己身陷困頓的城堡　讓我們拉著手
先別叫醒我　當我閉著眼	孩子的英雄　我能實現
相信四周　我們一起振作	放下鍵盤別抱怨　別急著道歉　我們都要改變
跨過守舊的界線　世界屬於イ尓和我	放下所有的成見熄滅心中對立那把火
開啓跨越國界的鑰匙埋藏在イ尓我心中	伴隨著音樂讓彼此靠近讓我們將愛掛星空
放下鍵盤別抱怨　別急著道歉　我們都要改變	對立的線　距離拉近點　多一點暸解　負能量刪減
讓愛出現イ尓我附近　沒人抛下　沒人被孤立	我們再次　團結一起　不再讓イ尓獨自一人度過逆境
沒有顧慮放下武器　不再傷害就沒有哭泣	不需顧慮只有鼓勵　我們都在努力　真心愛這土地
對立的線　距離拉近點　多一點暸解　負能量刪減	沒有顧慮放下武器　不再傷害就沒有哭泣
別讓自己身陷困頓的城堡　讓我們拉著手	我們比誰都清楚　別再相互的抵觸
令人難過　忘了怎麼認錯	相信四周　我們一起振作
不需顧慮只有鼓勵　我們都在努力　真心愛這土地	讓愛出現イ尓我附近　沒人抛下　沒人被孤立
科技冷漠　周遭感情冷落	人與人之間還有什麼能做
放輕鬆　毎個空ﾌ	先別叫醒我　當我閉著眼
我們用愛來體悟　痛徹心扉的領悟	開啓跨越國界的鑰匙埋藏在イ尓我心中
放下所有的成見熄滅心中對立那把火	讓我們擁抱彼此不管夜或是那白晝
人與人之間還有什麼能做	令人難過　忘了怎麼認錯
何もできずに悩んでいるよりも	この空を自由に飛ぶぞ
信じていけるって	その顔を上げて
その顔を上げて	どんな経験だって　そう
どうやって進めばいいのか	時に迷うケド
やれるさきっと自分を信じろ	次々起こるどんなことも
時に想う　あの鳥のように自由に	飛んでいけたらな〜
今はまだ笑えなくても	そのうちにきっと
たとえどんな道のりだとしても	やれるさきっと自分を信じろ
でもその手にぎってくれる人もいる	だから今は何が起こっても
だから今は何が起こっても	自分を信じるしかない!!
でも絶対に手に入れたいモノがある	だから今は何を言われても
立ち向かおう　この広い世界へ	時に人は悲しみ　そして喜びを知る
だから今は何を言われても	恐れずに進むしかない
一番大事にしなきゃいけないモノ苦しめて…	したいようにすればいい
自分を傷つけてどうする？	自分を嫌ってどうする？
時に人は悲しみ　そして喜びを知る	変えていける　不可能を可能へと！
自分を嫌ってどうする？	一番大事にしなきゃいけないモノ苦しめて…
あきらめる事は簡単だろう…	でも絶対に手に入れたいモノがある
時々手離され不安になるだろう…	でもその手にぎってくれる人もいる
したいようにすればいい	なりたいようになればいい
誰にも知られたくない悩みも	必ず解決できる時が来る
いつでもすぐに駆けつけるよ	いつでも…
伝えたいコトも 何から言えばいいのか 分からなくなるの…	笑ってて欲しい これからもずっと
色々あったネ… 思い出も そう あり過ぎるから	伝えたいコトも 何から言えばいいのか 分からなくなるの…
ふざけ合ったり 泣いたりもして 今が生きてるんだ…	嬉しい時、悲しい時、つらい時、
いつまでも幸せでいてよ	2人なら 乗り越えられるから
幸せにつつまれて 思い出すあの頃のコト	ふざけ合ったり 泣いたりもして 今が生きてるんだ…
だから いつまでも幸せでいてよ	2人なら 乗り越えられるから
ゴールの先には	なにが待ってるのか？
何を書けばいい?	適当じゃない
分かってほしい	あなたは　あなたは
たくさんあるケド	誰もきかない
決めるのは自分	ただ私は　この音に
あなたは　あなたは	ひとりじゃない!!
だから難しい	伝えたいこと
いつもとまた別の世界	見えてくから…。
耳かたむけて　何がきこえる?	雑音じゃない
伝えたいこと	たくさんあるケド
隠す感情　出させてくれる	どんな人間でも
どんな人間でも	チャンスをくれる
深く深く心で感じてみれば	いつもとまた別の世界
何を言えばいい?	何を書けばいい?
音楽がなきゃ　生きてないような	そんな気がする
適当じゃない	だから難しい
何度もなぐさめられて笑って	隠す感情　出させてくれる
どんなものでも	深く深く心で感じてみれば
キミがいるから	音楽がある
音楽がある	知らないうちに　作りだしてる
チャンスをくれる	そう何回でも
ただ私は　この音に	何度も　助けられたから!!
ならもう要らない	でもそうじゃない!
でもそうじゃない!	キミがいるから
知らないうちに　作りだしてる	分かってほしい
誰もきかない	ならもう要らない
言葉じゃ表せない　ほどの気持ちを	今をこの手、体、全てで
そっちの世界には　(もう慣れたのかな)	どんな場所?　どんな感じ?
何してるかな?　元気かな?って	思ってたんだよ
この手紙が	キミに届くように祈ってる
キミに届くように祈ってる	悲しい時もあるけど
ちょうどあなたのこと考えてた	何してるかな?　元気かな?って
思ってたんだよ	そっちの世界には　(もう慣れたのかな)
どんな場所?　どんな感じ?	聞きたいことが山ほどあるから!
平和求めて今も祈ってる	(1つの世界で)
(問題は限りない)	ケド戦うことだけが答えじゃない
そんなコト思っても　(黙ったままで)	人ごとのようにガラスに映ってる
アナタが思う幸せとは?	どんなものなんだろう…
憎しみ合うより	手をつなぎ合えば...
この広い世界のどこかで誰かが	頼れる場所　今も探してる
そのトゲは誰かを	キズ付けるためにあるんじゃない
性格や環境が違うだけで	その価値観はみな異なってく
この広い世界のどこかで誰かが	平和求めて今も祈ってる
窓をつたう水滴は　誰かの涙かも…	そんなコト思っても　(黙ったままで)
どんなものなんだろう…	性格や環境が違うだけで
覆われたバラの花束のように	そのトゲは誰かを
日々の営み　巡る光　落ちる影　物語	惑う民　惑うあまり　置いてけぼり　ひとはひとり
その中に　刻む時　その中に　ひとり　ひとり	色は混ざり　愛が灯り　ひとつになり　また始まり
なあ　見上げずとも　空は広い　なのに狭い	その中に　刻む時　その中に　ひとり　ひとり
惑う民　惑うあまり　置いてけぼり　ひとはひとり	なあ　見上げずとも　空は広い　なのに狭い
一緒に踊りましょう	どうっスか?
さあ!	聞かせてあげましょう!
何かやらずにはいられない	どうしよう!!
ドキドキ増すの	どうしたらいい?
まさに絶好調	今日のこのテンション
見たコトないものをみんなに	さあ!
どうしよう!!	誰か来る!!
今日のこのテンション	何かやらずにはいられない
道は続いてるどこまでも	キミの声が聞こえる間はあきらめない
長くて短い時間の中で	道は続いてるどこまでも
なつかしい雨の音色が	瞳をつぶるたびにきこえる
心が負けそうになっても	辿り着きたい
今までは気づかなかった	木のざわめき　鳥の声…
いつの間にか忘れてたケド	一輪の花がくれた勇気と希望を…。
走るたびに通り過ぎる	今までは気づかなかった
いつか見たあの夢	叶うことを信じて
苦しさに溺れそうでも	心が負けそうになっても
またもう1度	輝かせたいと思えるようになってた…。
キミの待つとこへ	いつか見たあの夢
ホコリかぶってた　だけど	またもう1度
動き続けてるいつまでも	キミの声が聞こえる間はあきらめない
大きくて小さい胸の中で	動き続けてるいつまでも
今までは気づかなかった	コンクリートに咲く花…
瞳をつぶるたびにきこえる	今までは気づかなかった
なつかしい風のにおいが	走るたびに通り過ぎる
生まれ持ったものだけが最高じゃない	自分の才能に気付いてないだけじゃない?!
育つんだ!! 空高くと　どこまで行けるかわからない	自分との戦いは…そう果てしない
短すぎるフリーダム、あなたはどう満たす?	何もしないまま通り過ぎる?
気付けば、“あっ”という間に過ぎてく時間	短すぎるフリーダム、あなたはどう満たす?
何か掴んだら胸にとっとこう	その感情、その感動、人に伝えてくそれも才能
周りは気にしないで	あなたらしく楽しんで
もう戦いを忘れ　今日は踊りましょう	憎しみを捨てて　今日から笑い合おう
うつむいてちゃもったいない	だって時間が過ぎるのはあっという間
そんな時もある　でも	人の愛で人は変われる
泣きたい時は泣けばいい	元気なヤツが支えればいい
元気なヤツが支えればいい	助け合えばいいじゃない
今なら素直に	家族、友達、恋人も
という気持ち	今なら素直に
だって時間が過ぎるのはあっという間	人の笑顔で人は変われる
あたり前のことが	出来なくなってた
いつの間にか	あたり前のことが
助け合えばいいじゃない	でもいつまでも
「ありがとう」	という気持ち
でもいつまでも	うつむいてちゃもったいない
家族、友達、恋人も	となりの知らない人も
初めて出会った所は、君が僕を知ったのは	夢の中から
二人でゆっくり過ごしたいけれど	君にも、僕にもやる事がある
相性はあってないけど、そんなには知らないけれど	心がはずむ
次に生まれて来る時も、僕と君は同じ気持ち	肩を並べて
階段に二人で座る 背中を丸め泣きながら	誰かが見ている
こんな綺麗な夜空に、巡り会えたのは	また深く、君の事好きになったから
今、丁度二人は違う場所にいる	だけどこの景色が僕をいやして
人目を気にせず抱き合えたら	街並みに溶けて行くよ いつも
心もがくわだかまりが	消えるのはいつの日か
どこか遠くへ行きたいな	何もかも忘れてさ
どれもうまくいかなくて	心もがくわだかまりが
必要とされているのかな？	愛されているのかな？
寂しくて寂しくて	今抱きしめられらくて
明日の不安もため息も	全部おいてくのさ
僕はあの人に	必要とされているのかな？
他人(ヒト)の優しさ想いやり	そっとこぼした笑顔
触れて胸が痛くなった	小さい自分だから
悔しくて悔しくて	ただ涙が止まらない
ただ涙が止まらない	心もがくわだかまりが
どれもうまくいかなくて	辛い辛いのわだかまりが
誰か教えてくれますか？	僕はあの人に
何もかも忘れてさ	明日の不安もため息も
辛い辛いのわだかまりが	消えるのはいつの日か
悲しくて悲しくて	どれもうまくいかなくて
今抱きしめられらくて	心もがくわだかまりが
そっとこぼした笑顔	触れて胸が痛くなった
まるで獣のオスとメス	理性を失った愚かな本能で
こんな時間にまさかの電話	酔った勢いって調子いい
「やっぱお前やないとあかんねん」	なんて実際のとこ一度もないし
許されるなら今すぐ逢いたいって	変わらないあたしで飛び込むわ
理性を失った愚かな本能で	優しさに甘えてはまた温もりを求める
そうやって拒めないで許して繋いでいたっけ…	「やっぱお前やないとあかんねん」
居心地のいい	でもとっても都合のいい関係じゃない？
あの笑顔も嘘じゃない	そうさ全てがまやかしの夜じゃない
お前も薄々感づいてんのちゃうの？	コレが実らぬ恋だなんてくらい
でも弱った声に優しくなる	ねえあんなに一緒にいたのに
叶わない祈り	寂しい夜に
酔った勢いって調子いい	でも弱った声に優しくなる
あれから何度も奇跡の夜	信じてんのバカみたいよ
あなたはいま過去の人…	あなたはもう過去の人…
分かってんのに	居心地のいい
コレが実らぬ恋だなんてくらい	アルコールの香りとともに
演じてる“いい女”強がりでも	大人になったでしょ？あたしも
変わらないあたしで飛び込むわ	演じてる“いい女”強がりでも
許されるならもう一度やり直して	また同じ夢を見ていたい
ねえあんなに一緒にいたのに	あれから何度も奇跡の夜
繰り返す過ち	分かってんのに
付かず離れず二人抱き合っては	凍えそうな温もり残した
でも伝えた言葉に偽りはない	あの笑顔も嘘じゃない
また同じ夢を見ていたい	でも好きだとか言わない負けた気して
未来を崩してく甘い罠	付かず離れず二人抱き合っては
でも好きだとか言わない負けた気して	大人になったでしょ？あたしも
寄り添えば愛しい	叶わない祈り
許されてきた二人の愛し方	未来を崩してく甘い罠
負けず嫌いな性格はそう	君を裏切らない
嗚呼、夢が君を作り	夢が君を壊してく
よく笑っていて	でも全部君の想いやりだと
西口を出たら商店街	この街に住んでどれくらい？
犠牲にしたものはきっと数知れず	嗚呼、報われない明日を
他人に誤解されるくらい	よく笑っていて
この街に住んでどれくらい？	少し痩せたんじゃない？て言えば
ここのラーメンがうまいとか	ここでレンタルをするだとか
嗚呼、手にしたいものがある	君はこれほどに
夢が君を壊してく	また今日ももがき生きていくこの街で
嗚呼、余計なことは言わない	指図もしたくない
指図もしたくない	笑顔の奥のため息が聞こえたよ
いつだって陽気な人で	他人に誤解されるくらい
嗚呼、報われない明日を	何度恨んだんだろう
何度恨んだんだろう	遠く揺れている背中がたくましい
人は誰だって褒められたいし	好かれたいしすごいと言われたい
君はこれほどに	犠牲にしたものはきっと数知れず
ここでレンタルをするだとか	すぐに辞めたバイト先とか
嗚呼、報われない明日を	何度恨んだろう
気の利いた　言葉も言えなかった	でも君を誇りに思うよ
すぐに辞めたバイト先とか	増えたプロフィール紹介して
帰りに渡されたチョコ	僕の好きなコーヒーの
でも全部君の想いやりだと	僕は知ってるから
少し痩せたんじゃない？て言えば	ごまかしてふざけていた君
溶け出した　想いとチョコレイト	握ったまま僕は何ひとつ
また今日ももがき生きていくこの街で	嗚呼、余計なことは言わない
誰かに抱きしめてもらえるのかい？	帰りに渡されたチョコ
好かれたいしすごいと言われたい	負けず嫌いな性格はそう
握ったまま僕は何ひとつ	気の利いた　言葉も言えなかった
何度恨んだろう	遠く揺れている背中がたくましい
寄り添って眠る場所はあるのかい？	誰かに抱きしめてもらえるのかい？
幸せそうな横顔　はじめて綺麗って思ったよ	照れくさい慣れない「おめでとう」
あなたの幸せ心から願うよ	本当に「おめでとう」
「勝手に人のもん使うな」ってそれくらいイイじゃない減るもんじゃないし	なんて喧嘩もなくなるし　お風呂だって待たなくてよくなるし
どこか寂しそうな横顔　見たらこっちまで寂しいよ	涙は拭いて笑顔で　言わせて素直に「おめでとう」
あのね、ずっと探してたオレンジのチークあたしが持っているの	なんだかんだあなたを見て　おしゃれや恋を覚えていったから
別にそんな大袈裟にしなくてもいつでもまた会いに行けるのに	笑ってお祝いするって決めたのに　なんだろう涙出ちゃうよ
生まれてきてから今日まで　ありがとう大好きお姉ちゃん	あなたの幸せ心から願うよ
あなたとお別れ	別にそんな大袈裟にしなくてもいつでもまた会いに行けるのに
照れくさい慣れない「おめでとう」	あなたの笑顔が素敵な日
愚痴やわがままもそれくらい平気だよ	強気なあなたも　弱虫なあなたも　よく似てるから分かるよ
カレンダーのハートマーク　近づいても何も感じなかったけれど	片づいた部屋見渡し　ため息ついてるあたしがいたんだ
たまにはメールや電話もしていいよ？	愚痴やわがままもそれくらい平気だよ
幸せそうな横顔　世界でいちばん綺麗だよ	照れくさい慣れない「おめでとう」
照れくさい慣れない「おめでとう」	あなたの笑顔が嬉しくて
あなた選んであなたの側に	きっといたんでしょう
この人生もっとハッピーに	したいって思うから
大事に大事に抱きしめて	また歩き出すよ
後悔しないことなんて	きっと僕不器用で
したいって思うから	あなた選んであなたの側に
ずっと一緒だって約束したタローも	あんなに元気だった隣のじいの笑顔も
きっと僕不器用で	この先もありえないけど
僕にできること	二度と戻らない時間を責めてもしゃーないの
あなたが落っことしていった優しさのかけらを	大事に大事に抱きしめて
したいって思うから	あなたの笑顔何万回も咲かせましょう
あなた選んであなたの側に	今いるんでしょう
きっといたんでしょう	人は皆いつかさよならきてその最大の
無防備に眠るその横顔に	布団をかけてキスして
きっといたんでしょう	あなたが落っことしていった優しさのかけらを
変な意地は捨てて	素直にごめんね言ったのに…
この人生もっとにハッピーに	したいって思うから
布団をかけてキスして	おやすみってつぶやくわ
当たり散らした喧嘩のあとも	変な意地は捨てて
思い出せば笑っちゃうような	くだらないことさえ宝物なんだよ
なぜ？想いやりひとつ	あなたに差し出すこと惜しんだんだろう？
誰にも約束されない明日がある	また次じゃなく“今”と向き合えれば…
悲しみも受け止めて	伝えたいよ「ありがとう」
この先もありえないけど	僕にできること
もしも未来を知っていたなら	当たり散らした喧嘩のあとも
人は皆いつかさよならきてその最大の	悲しみも受け止めて
ずっと見てられるって思ってたよ子供の頃	時の中で　歳を重ね　別れ数え　今日の日まで
あなたの笑顔何万回も咲かせましょう	人は皆いつかさよならきてその最大の
もしも未来を知っていたなら	無防備に眠るその横顔に
あんなに元気だった隣のじいの笑顔も	ずっと見てられるって思ってたよ子供の頃
二度と戻らない時間を責めてもしゃーないの	今はただ目の前のあなたに愛を…
笑顔を遠ざけた	君が隣にいることが
“君”を作るのは	僕の自由だからいつも
たまに怖くなるけど	こぼしてった想いやりが
君のコトよく知らないけど	弱いものに優しい人
羨ましがるのは	もうやめようだから今日も
まだ見ぬ君の毎日に	寄り添って歩きたい
空の青や赤や灰色(くもり)	同じもの見ていたい
欲ばりが孤独を呼んで	笑顔を遠ざけた
狭い部屋　膨らむ気持ち	君のコトよく知らないけど
こぼしてった想いやりが	僕を守っていた
幸せってきっと誓いあったり	人に見せるものじゃないから
僕の自由だからいつも	柔らか目信じてたい
同じもの見ていたい	まだ見ぬ君の毎日に
人に見せるものじゃないから	いつまでも側にいれたらいい
うまく笑えないけど	君が隣にいることが
夜の風運ぶメロディ	狭い部屋　膨らむ気持ち
欲ばりが孤独を呼んで	うまく笑えないけど
良くも悪くもさ	“君”を作るのは
もうやめようだから今日も	君に向かう愛感じて…
夢見ることたくさんあるけど	幸せってきっと誓いあったり
君が隣にいることが	本当は幸せ
他の誰かをさ	羨ましがるのは
多くを語らない君が	たまに怖くなるけど
こんなこと思っていいのかな…	本当にあたしこの人でよかった？って今更
恋をして夢を見てきたの	愛を知り強くなるんだね
不安なのは今だけって	強く抱きしめてよ
素直になれたんだと	わがままとはき違え…
とてつもなく臆病で…	そんな時は黙って
楽しいはずなのに	いいんじゃない？て一言苛立って
こんなこと言っていいんかな…	こんなこと思っていいのかな…
式場のあれこれとか	新しい家具どうするか
愛を知り強くなるんだね	隣があたしでよかったと
電話出るとき	君の名を言えるのが嬉しくて…
多くを期待してきたから	見失うこともあったけど
始まりを迎えるそのとき	どんな時も笑顔絶やさず
きっといつもの二人でいい	多くを期待してきたから
辛い過去乗り越えてきたんだよ	信じたい君との今日まで
だけど君じゃなきゃダメだって	随分繰り返してきたんだ
どんな時も笑顔絶やさず	大きな愛で君を守りたい
わがままとはき違え…	そんな時はバカだって
夢だったの花嫁に	なることは昔から
踏ん張って立ってくれている	そうだよね？ねえいつも
嫌いって何度も突き放して	だけど君じゃなきゃダメだって
あたしをひとりにする	不安なのは今だけって
信じたい君との今日まで	また振り返る日には笑ってたい
君に向かう気持ちが	とてつもなく臆病で…
きっと君はあたし以上に	覚悟と不安に挟まれて
覚悟と不安に挟まれて	踏ん張って立ってくれている
隣があたしでよかったと	いつの日も思わせるから
期待してまた裏切られて	嫌いって何度も突き放して
大丈夫。だと	微笑む優しさ持って支えたい
今君を選んだ人生	始まりを迎えるそのとき
今誰の話も、	通りすぎて上の空緊張して
スーツを身にまとってても	君はいつもの君のまま
そうだよね？ねえいつも	そうなのに…
見失うこともあったけど	誰よりもねえ君を、愛してる
そんな時は黙って	ギュッて抱きしめて欲しい
新しい家具どうするか	楽しいはずなのに
そんな君を和ませる	それがあたしの役目
君はいつもの君のまま	今誰の話も、
そんな時はバカだって	ちゃんと叱って欲しい
なることは昔から	電話出るとき
君の視線どこか遠く	あたしをひとりにする
長い夜朝を迎えたよ	辛い過去乗り越えてきたんだよ
それがあたしの役目	大丈夫。だと
生まれた時から	行かなくちゃ早く行かなくちゃ
見えないから怖いでも	見えないから見たくて
やだよやだよこんなの	何でこんなにも
真夜中三時に夢迸り	チカチカ照らすわ　いつか　きっと　そっち行くよ
道なきみちをあるいた	見えないから怖いでも
ゆらゆら揺れてる　今宵　昇る　月のごとく	遥か遠くても夢迸り
見えないから見たくて	ここまでやってきたの
始まりはどこだ終わりはどこだ	ドキドキ鳴らした　胸の　奥の　重低音
小さな光は	いったいどこに行ったんだ？
ゆらゆら揺れてる　今宵　まんまる　月のごとく	始まりはどこだ終わりはどこだ
帰る場所なんてない	生まれた時から
行かなくちゃ早く行かなくちゃ	森の中で見てきた
背負ってたんだよ	期待も時として化けもの
ゆらゆら揺れてる　今宵　まんまる　月のごとく	真夜中三時に夢迸り
儚いと読むみたいだ	儚いならなおさらさ
チカチカ照らすわ　いつか　きっと　そっち行くよ	まわれ　まわれ　止まらないで
期待も時として化けもの	やだよやだよこんなの
遥か遠くても夢迸り	チカチカ照らすわ　いつか　きっと　そっち行くよ
森の中で見てきた	小さな光は
何でこんなにも	楽しいも苦しいになる？
吐いてきた言葉だけ	背負ってたんだよ
あたしが描いた夢物語	ゆらゆら揺れてる　今宵　昇る　月のごとく
儚いならなおさらさ	守っていかなければ
人の夢は文字どおり	儚いと読むみたいだ
あたしが描いた夢物語	ゆらゆら揺れてる　今宵　まんまる　月のごとく
ドキドキ鳴らした　胸の　奥の　重低音	体　いっぱい　響く限り
リズムをなくした僕を揺らす	うたは時に僕のエンジンさ
今ならここから飛べる気がする	そんなこと言っちゃまた試練ですか？
うたは時に僕のエンジンさ	欲深く幸せ願うのは
疲れたなもう頑張れないや	神様諦めてもいいですか？
ららる　ららる	只今心の病　ららる
ヤバイヤダし　なら　ららる	単純だけど楽しくなってる
光が生まれてできた陰	なら探そうか反対側まで
逃げ道をひたすら考えてる	そんな労力あるなら前を向け
ららる　ららる	指を回してうた唄う　ららる
真っ暗闇に覆われて	立ちすくむでもきっとどこかで
立ちすくむでもきっとどこかで	光が生まれてできた陰
青空はそう他人事	でもこんな僕にも優しいね
光があるから陰を持つ	太陽は希望と絶望さ
単純だけど楽しくなってる	僕は生きてる
胸が急にキュンてなる　ららる	僕は生きてる
なんだか切ない　ららる	胸が急にキュンてなる　ららる
そんな労力あるなら前を向け	無責任にも正しいお告げは
欲深く幸せ願うのは	過去の僕が夢を観てたから
神様諦めてもいいですか？	今ならここから飛べる気がする
只今心の病　ららる	ヤバイヤダし　なら　ららる
指を回してうた唄う　ららる	なんだか切ない　ららる
でもこんな僕にも優しいね	光があるから陰を持つ
無責任にも正しいお告げは	僕の守護霊か？更生係
僕らどれくらい丈夫かって	無駄にぶつかり傷付けたりした
変だな　なんか	君に僕　優しい
眠れば来る揃いの明日が	汚れなき夢描き続けてた
完成された“理解者”なんだ	一人の道　一番の強み
交差点の先映し出すビジョン素晴らしいから	君選んだ道迷わないで進めばいい
二人で何を話そう？	変だな　なんか
知らないフリした	いつかの今日
時間がないな	もうすぐさよならだね
無駄にぶつかり傷付けたりした	眠れば来る揃いの明日が
遠回りも　今日までにしてさ	完成された“理解者”なんだ
もしもさ、君の	弱虫あらわれたら
君差し出した手を繋いで歩いてた道	きっとそんなことが僕の生きる意味になった
今更　今から	二人で何を話そう？
きっとそんなことが僕の生きる意味になった	絶妙なニュアンスのいい言葉出てこないか…
絶妙なニュアンスのいい言葉出てこないか…	でもこんなことはできる君にうた唄うよ
何年後先もずっと二人のあの頃は	背を向けて歩く君と僕支えるから
弱虫あらわれたら	教えてあげよう
今繋いだ手話すよ僕らきっと未来には	新しい何か掴んでくんだその手でほら
教えてあげよう	君が持つ才能
まっすぐ伸びた夢道を二人歩いた	きっとそんなことが僕らを随分　大人にした
もうすぐさよならだね	知らないフリした
新しい何か掴んでくんだその手でほら	交差点の先映し出すビジョン素晴らしいから
離れてこそ素直でいたいな	遠回りも　今日までにしてさ
きっとそんなことが僕らを随分　大人にした	何年後先もずっと二人のあの頃は
いつも気になっていた景色が目の前に	肩を組んで花道を行くんだ
一緒に曲を作って、パスタを食べて	今日も可愛いねって言ってキスをして
そんな大したことは起こってないよ	外が暑くてベタベタになるだけで死にたいし
甘いスイーツ食べて友達と笑えるだろ？	だいすきなあのバンドのライブに行けるし
思い描いてた通りの1日だった、とか	落し物を拾って届けた、とか
そんな大したことは起こってないよ	でも空が青いと写真を撮って綺麗だねって
でも空が青いと写真を撮って綺麗だねって	見せたいし頑張ったねって頭撫でて欲しい
今日も可愛いねって言ってキスをして	ジリリ、朝だ、死にたい
今日もお前は世界一可愛かった	ほら、あの夢の続きを見てきな
だいすきなあのバンドのライブに行けるし	今日もお前は世界一可愛かった
落し物を拾って届けた、とか	そんな大したことは起こってないよ
外が暑くてベタベタになるだけで死にたいし	安いファンデが割れただけでも死にたい
寝てる間だけでもいい夢見なよベイビー	あの人の恋人になって家で猫と遊ぼう
寝てる間だけでもいい夢見なよベイビー	あのバンドと一緒に城ホに立ってる
起きてる間もいいことあるさベイビー	甘いスイーツ食べて友達と笑えるだろ？
君が私のそばにいないから、とか	飼ってたペットが死んだから、とか
今日はいつもより顔の調子がいい、とか	思い描いてた通りの1日だった、とか
飼ってたペットが死んだから、とか	友達が自殺したから、とか
あのバンドと一緒に城ホに立ってる	いつも気になっていた景色が目の前に
安いファンデが割れただけでも死にたい	私はそんな人間にしかなれない
肩を組んで花道を行くんだ	ジリリ、朝だ、夢か
見せたいし頑張ったねって頭撫でて欲しい	私にそんな人いないんだった
あの人の恋人になって家で猫と遊ぼう	一緒に曲を作って、パスタを食べて
友達が自殺したから、とか	そんな大したことは起こってないよ
何度目かの恋が私に教えてくれた答え	流行とか可愛い名前には憧れるけど
お気に入りのクッション分け合い座り	触れ合うペアリング　君と目がリンク
触れ合うペアリング　君と目がリンク	幸せが流れるこの部屋に
会いたい時は素直に言葉にするよ	何度目かの恋が私に教えてくれた答え
流行とか可愛い名前には憧れるけど	君がいつでも呼んでくれる　だから自分の名前が好き
ちょっとわがままな君が好き	次から次と気持ちが溢れて止まらない
気付いた時にはいつものように君と二人	お気に入りのクッション分け合い座り
声が聞きたくて　でも繋がらないケータイ	そんな時はやっぱ独り占めしたくなるの
一人でもきっと頑張れる　でも	二人ならもう怖い事なんてないよ
初めて話した時　恋に落ちる予感通り越して	好きになってた　もう戻れないと思った
俺にはちょっと理解できず	たまに突き刺さりすぎて痛いです
愛しい想いは永遠に　ずっと私だけを見て	何度も君に恋してる　不安もたまにはあるけど
でもね　新しいフレーズ見つけたなら　いつもより嬉しい	誰より早くその腕の中で　歌って聞かせたいよ
心配すんな理屈じゃなくて　ただ君と笑っていたくて	振り上げる繋いでた手　空にめがけ幸せ描け
君の事になると小さな不安でも　すぐに泣きたくなった	でもね　新しいフレーズ見つけたなら　いつもより嬉しい
夜中に君と電話で喧嘩	二人して意地張り合ってませんか?
幸せが流れるこの部屋に	心配すんな理屈じゃなくて　ただ君と笑っていたくて
打たれ強いって思ってたのに	君の事になると小さな不安でも　すぐに泣きたくなった
好きになってた　もう戻れないと思った	同じ気持ちだと知ったあの夜　今でも覚えてる　君の笑顔
一緒に出かける君のペースで	でもたまにくしゃって見せる笑顔　愛しいから
ロマンチックだなんて　ほど遠い不器用な	マイペースで子供みたい　その笑顔を許しちゃうよ
君と待ち合わせて　目と目が合う瞬間	心と心が溶け合うかのような愛しい距離
例えば欲しい物が花束なら	君が用意する物はお菓子とかね
見えない優しさも　本当は甘いところ	私だけが知ってる　君の強がりでも受け止めるよ
言葉よりも先に包みたい	伝え合う何度でも
本当は甘く優しい強がりな人だね　そばにいるよ	こんな近くで見つめてたら　気づかないかもね
ロマンチックだなんて　ほど遠い不器用な	本当は甘く優しい強がりな人だね　そばにいるよ
こんな近くで見つめてたら　気づかないかもね	その笑顔を変わらず見せてね
目に見えないと不安になる	その度強く抱きしめて
これ以上　見失わぬように	ぬくもり忘れないように
何もない道でも二人の世界は	いつも素敵ドキドキ変わりゆく景色　それもいいね
マイペースで子供みたい　その笑顔を許しちゃうよ	子猫みたいに気ままなしぐさに　うつむき　微笑む
また笑っちゃう　はしゃぐ君に	思わず顔を両手で引きよせた
その度強く抱きしめて	これ以上　見失わぬように
心と心が溶け合うかのような愛しい距離	言葉よりも先に包みたい
私だけが知ってる　君の強がりでも受け止めるよ	こんな近くで見つめてたら　気づかないかもね
君が用意する物はお菓子とかね	一緒に出かける君のペースで
思わず顔を両手で引きよせた	何もない道でも二人の世界は
何を思いながら人は生きていくのだろう…	あなたは何のために生きてる?
「胸の奥が　あたたかくて　苦しくて」	「少しずつ、愛の力が彼女を変えてく」
愛している　あなたの声　聞きたかった　ずっと	「おかえり」って　言って…
「神様まだ　生まれ変わる　ことができるなら」	「人は変われるの」
「気づいたの」	「今」
ここでは人が起きて、働いて、食べて、	眠るだけ、、、、　それが人生なら
朝、目が覚めればまた同じコトのくり返し…	同じ顔、同じ場所で
「少しずつ、愛の力が彼女を変えてく」	「神様まだ　生まれ変わる　ことができるなら」
「生きる」	「愛のために!」
「ずっと」	「進む」
「人は変われるの」	「気づいたの」
「今」	「ずっと」
「進む」	「生きる」
何もすることのないカベの中で、	人は何を感じ生きていくのだろう?
運命がにくい　人の世の	どうにもならぬと　言いながら
生れて来なけりゃ　よかったと	幸せうすい　幸せうすい　北の果て
舞う粉雪に　まぼろしの恋しい人の	面影を　いつか映して　また消える
あなたの面影　抱きしめながら	さまよい歩く　雪の中
北国の吹雪のなかに散った　男と女の　女と男の	それはあまりにもはかない　青春であった…
雪が降る降る　雪が降る　ここさい果ての街に雪が降る	いつまでも語りつがれる　男と女の　女と男の　悲恋物語
いつまでも語りつがれる　男と女の　女と男の　悲恋物語	はたして二人の運命やいかに　北国浪漫　全編の終わり
雪が降る降る　雪が降る　ここさい果ての街に雪が降る	親に反対され　世間にそむかれ　一筋の愛に生きて
どうにもならぬと　言いながら	吹雪のなかを　吹雪のなかを　消えた人
死んで二人が天国で結ばれるなんて　そんなの嘘よ　嘘なのよ…	舞う粉雪に　まぼろしの恋しい人の
はかない女の　恋一度	名のみの春よ　名のみの春よ　なぜ遠い
冷たくしみる　雪野原	生れて来なけりゃ　よかったと
さまよい歩く　雪の中	はかない女の　恋一度
愛しているのに　一緒になれぬ	運命がにくい　人の世の
幸せってなんなの　白い雪と共に消えてしまうものなの	それとも夢なの…
親に反対され　世間にそむかれ　一筋の愛に生きて	北国の吹雪のなかに散った　男と女の　女と男の
流れる涙が　からだの骨に	冷たくしみる　雪野原
それとも夢なの…	私はいや　いや　だからどんなにつらくとも　生きていたい
寄り添う二人　包むよに	夜の灯りが　ゆれている
乾いてたこの街に　夢が降る	銀色の雨
愛されている事の　幸せしみる	寄り添う二人　包むよに
恋をするって　こんなに心がはずむ	何気ない景色さえ　きれいに見える
夜の灯りが　ゆれている	乾いてたこの街に　夢が降る
銀の雨って　やさしい雨ですね	恋をするって　こんなに心がはずむ
あなたのあとを　何処までも	ついて行きたい　離れずに
ついて行きたい　離れずに	街路樹の枝先に　夢が降る
銀の雨って　素敵な雨ですね	濡れてみたいの　傘などいらない今は
街路樹の枝先に　夢が降る	銀色の雨
何もないこの街に　夢が降る	銀色の雨
抱きしめてこのままで　時間を止めて	好きなのとても　たまらない
あなただけしか　見えないの	何もないこの街に　夢が降る
銀の雨って　不思議な雨ですね	つらい涙も　いつしか流してくれる
つらい涙も　いつしか流してくれる	愛されている事の　幸せしみる
好きなのとても　たまらない	あなただけしか　見えないの
濡れてみたいの　傘などいらない今は	抱きしめてこのままで　時間を止めて
何気ない景色さえ　きれいに見える	あなたのあとを　何処までも
キラキラネオンは光る星	ふらふら気まぐれ夜風に酔って
うつろな瞳にタワーがゆれる	一本二本三本目
一夜明ければ消える街	今夜は私に灯りをともして
女の溜息教えても	四本五本六本木　悪い涙を捨てた街
さらさらロアに風が吹く	ゆらゆら浮気にこの身もゆれる
誰でもいいから送ってちょうだい	誰でもいいから送ってちょうだい
四本五本六本木	一夜明ければ消える街
四本五本六本木　影が重なる街灯り	夜明けが来るまで二人で飲もうよ
四本五本六本木　悪い涙を捨てた街	誰でもいいから送ってちょうだい
一本二本三本目	噂のローソク灯しても
ふらふら気まぐれ夜風に酔って	アマンドあたりで声かけて
最後の煙草に火をつけて	四本五本六本木　影が重なる街灯り
お別れしましょう外苑通り	一本二本三本目
一本二本三本目	最後の煙草に火をつけて
一本二本三本目	女の溜息教えても
チラチラ夢まで追いかけて	くらくら口づけかわせばさめる
アマンドあたりで声かけて	肩寄せ歩けば狸穴通り
肩寄せ歩けば狸穴通り	一本二本三本目
ゆらゆら浮気にこの身もゆれる	アマンドあたりで誘われて
アマンドあたりに帰されて	お別れしましょう外苑通り
アマンドあたりで誘われて	うつろな瞳にタワーがゆれる
くらくら口づけかわせばさめる	アマンドあたりに帰されて
噂のローソク灯しても	四本五本六本木
泳ぎ疲れてみたくなる	君と夢の珊瑚礁　(抜けて)
真っ白なシャツ着た　(君はまるで)	人魚のように素敵で　(エモーション)
どこまでも深く　(深く)	恋におちていく
君と夏の太陽　(浴びて)	どこまでも深く　(深く)
このままサカナになって	海の中を泳ごう
何度も　(失くして)　何度も　(見つけて)	人を好きになるのって　不思議
時を止めたくて	思わず息を止めた
真珠の　(ヒカリも)　花火の　(派手さも)	君には　敵わないのだろう
なびく髪ふわり　(ふわる)	時を止めたくて
やがて虹に変わるころ	新たな　(季節に)　世界は　(色づく)
触れたら消えてしまう	恋するゼリーフィッシュ
ただの友達のまま	恋するゼリーフィッシュ
海の中を泳ごう	君を思い描くたび
あと少しだけ　(もう少しだけ)	近づいてみたいけれど
始まりがゆらり　(揺れる)	振り向いた笑顔
君と香る潮風　(浴びて)	なびく髪ふわり　(ふわる)
君と夢の珊瑚礁　(抜けて)	始まりがゆらり　(揺れる)
ジリジリ心焦れてゆく	君と香る潮風　(浴びて)
波で遊んだ　(子供のように)	無邪気になれない僕は
君と白い砂浜　(走る)	あこがれは遠く　(遠く)
新たな　(季節に)　世界は　(色づく)	夏のはじまりへ　駆けていく
振り向いた笑顔	プリズムよりも綺麗
無邪気になれない僕は	ただの友達のまま
肌が焼けるたび	ジリジリ心焦れてゆく
ふたりでサカナになって	海の中泳ぎたい
さらわれて消えてしまえ　(ハレーション)	何度も　(失くして)　何度も　(見つけて)
海の中泳ぎたい	想像した後先は
思わず息を止めた	波で遊んだ　(子供のように)
人魚のように素敵で　(エモーション)	真珠の　(ヒカリも)　花火の　(派手さも)
プリズムよりも綺麗	あと少しだけ　(もう少しだけ)
恋におちていく	泳ぎ疲れてみたくなる
臆病な言葉は　(波の向こう)	さらわれて消えてしまえ　(ハレーション)
近づいてみたいけれど	触れたら消えてしまう
突然降りだした　(天気雨)	やがて虹に変わるころ
あこがれは遠く　(遠く)	肌が焼けるたび
あれ…夢なのかな？	ままままさか
ほら全部で全部に恋しよう	ハイ！ハイ！ハイ！
夢なのかな	あれ…夢なのかな？
人生変わるくらいの達成感	叶えましょう
夢と努力でキレイを作るの	ときめきましょうね
ややややばい	幸せかも〜！
ままままさか	ドキドキだもん！
お友達だったのに (なぜ)	ノーマークだったのに
出会っちゃったみたい	世界がうらやむような大恋愛
ハイ！ハイ！ハイ！	ほら全部で全部に恋しよう
見つめちゃってみたい	キスしちゃってみたい
致しましょう	育みましょう
本気で本気の恋しよう	ハイ！ハイ！ハイ！
電流が走ったの (ビビ)	あなただと気付いたの
育みましょう	愛と勇気でセカイを変えるの
世界がうらやむような大恋愛	致しましょう
叶えましょう	繋がりましょう
育みましょう	愛と勇気があればいい
繋がりましょう	夢と努力でキレイを作るの
意識しちゃう	意識しちゃいます
キスしちゃってみたい	人生変わるくらいの達成感
親からの電話にも (リンリン)	なぜかギクリとしちゃう
意識しちゃいます	ややややばい
愛と勇気でセカイを変えるの	がんばりましょうね
ハイ！ハイ！ハイ！	本気で本気の恋しよう
恋しちゃったみたい	出会っちゃったみたい
運動会の当日に　雨	キャンプに行ってキャンプファイヤー雨
雨があがって　虹が出て　雨	優勝して　ビール掛け　雨
近所のおばちゃんに　飴もらう　雨	けんかになる　テメーオメー　雨
キャンプに行ってキャンプファイヤー雨	誕生日にケーキくる　雨
優勝して　ビール掛け　雨	目がかゆくなる　目薬さす　雨
雨乞いをする　直前に　雨	近所のおばちゃんに　飴もらう　雨
砂漠で遭難して	のどが乾き　しにかけて　晴れ
自分で注文したいけど	普通に言ったらわさびが入る
甘えびさびぬき	えんがわさびぬき
いかのさびぬき	たこのさびぬき
普通に言ったらわさびが入る	僕は子どもださびぬきだ
僕は子どもださびぬきだ	大きな声で言ってやる
トロのさびぬき	甘えびさびぬき
えびのさびぬき	サーモンのさびぬき
サーモンのさびぬき	鉄火のさびぬき
えんがわさびぬき	パパはビールだ栓抜き
早く大人になりたいよ	わさびが入ったらお鼻がツーン
まぐろのさびぬき	いかのさびぬき
トランプババ抜き	運動会ごぼう抜き
運動会ごぼう抜き	的は射抜き
鉄火のさびぬき	たまごは元からさびぬき
僕は子どもださびぬきだ	勇気を出して言ってやる
的は射抜き	鼻毛は毛抜き
うどんは讃岐	トランプババ抜き
たいのさびぬき	トロのさびぬき
おなかぽんぽこぽん	たぬき
寿司はさびぬき	うどんは讃岐
わさびが入ったらお鼻がツーン	僕は子どもださびぬきだ
鼻毛は毛抜き	おなかぽんぽこぽん
はまちのさびぬき	かつおのさびぬき
たこのさびぬき	えびのさびぬき
かつおのさびぬき	たいのさびぬき
旅立ちを決めたのは　勢いだけじゃないから	あなたと過ごした日は　20世紀で最高の出来事!!
安らぎが欲しかった　誇れる場所が欲しかった	だけど大切なのは　あなたとあの日　出会えたことね
やけに思い出しちゃって　スーツケースに入れとこう	旅立ちを決めたのは　勢いだけじゃないから
あざやかに描かれた　虹のドアをきっとみつけて	心をときめかせている
なんで私に優しいの?	理由なんかない、理由なんか…
理由なんかない、理由なんか…	守ってあげたい心から思うよ
私には呪われた人狼の血が流れている	実の親にすら見捨てられた
実の親にすら見捨てられた	手なずけようとしても無駄だ
何が目当てなの?	なんで私に優しいの?
手なずけようとしても無駄だ	私が信じられるのは、マスターだけだ
私強い子じゃない　ワガママで甘えん坊だから	いつも心の中　戸惑い考えてた
ふざけて夜道をうすい影見て歩いたね	涙があふれる　うずくまる胸が近すぎるよ
明日はきっと今日より強い笑顔、熱い瞳	誰よりもそう強がっていた　あなただけに
二人だけの季節　誰かがそっとアイズしたよ	悲しみ、喜び　全てうつす空が見たい
ざわめく街の灯りも　ぬるい風も	二人だけの季節　誰かがそっとアイズしたよ
私強い子じゃない　一人だと壊れそうだから	二人一緒だよね　約束忘れないで
過去は忘れるもの　癒えぬ傷たくさんあるけど	未来創りだそう　ねぇ今思いついた
私強い子じゃない　いつまでもそばにいたいけど	あなたの優しさに包まれ　ずっとこのまま
悲しみ、喜び　全てうつす空が見たい	ためらい、迷いも　消し去ってくれるあなたとなら
あの日きつくあたって困らせたね	明日はきっと今日より強い笑顔、熱い瞳
涙があふれる　うずくまる胸が近すぎるよ	私強い子じゃない　ワガママで甘えん坊だから
足りない言葉が一つ　片隅に埋もれてる	素直に「愛してる」となぜかうまく言えなくて
あなたの優しさに包まれ　ずっとこのまま	私強い子じゃない　一人だと壊れそうだから
だけど今ホントの気持ちはここにしかないから	ふざけて夜道をうすい影見て歩いたね
誰よりもそう強がっていた　あなただけに	だけど今ホントの気持ちはここにしかないから
ためらい、迷いも　消し去ってくれるあなたとなら	過去は忘れるもの　癒えぬ傷たくさんあるけど
何かと別れて初めて強くなれるんだ	今こそ翼を広げるときさ　こわがらず精一杯飛び立つのさ
両手にあふれる伝えたい言葉　痛みも弱さも強がりも全部	あなたの願いをあきらめないで
抱きしめ合っている　空と大地が　あの雲の下でもう一度想う	風になれ
胸に染み付く弱さを隠さないで	抱きしめ合っている　空と大地が　あの雲の下でもう一度想う
今こそ翼を広げるときさ　こわがらず精一杯飛び立つのさ	重なり合っている手と手を見れば
あなたの願いをあきらめないで	駆け抜ける過去を現在を未来をきっと
あなたの願いをあきらめないで	胸に染み付く弱さを隠さないで
降り注ぐ雨の中今　世界中の夢集めたなら	子供を持った母のように　一晩中でもこの手で抱いて祈るよ
駆け抜ける過去を現在を未来をきっと	愛して生きるよ　どんなときにでも
空より海より　風より波より　夢より尊い	僕達になれ
卒業アルバムの中で　誓った未来	誰もが一度は無邪気に思い返すだろう
この世の全ては　一つになれると	わかるだろう
重なり合っている手と手を見れば	この世の全ては　一つになれると
祈ってる　子供の頃と変わらぬ願い	卒業アルバムの中で　誓った未来
降り積もる　闇と光は隣り合わせさ	心の奥にいつかは「さよなら」がある
心の奥にいつかは「さよなら」がある	何かと別れて初めて強くなれるんだ
朝日が昇った始まりの時　はるかな道へ運ぶよ生まれた勇気	両手にあふれる伝えたい言葉　痛みも弱さも強がりも全部
愛して生きるよ　どんなときにでも	空より海より　風より波より　夢より尊い
ふとした瞬間の　さり気ない仕草	いつの日にか　夢を語る　あなたの顔をずっと
少し幅の違う足で　一歩ずつ歩こうね	二人で歩む道　でこぼこの道
たどり着いた　二人の場所　長すぎた旅のあと	誓った愛を育てよう
言葉が今　時を越えて　永遠を突き抜ける	幾つもの季節を通り過ぎて
雨上がり、気まぐれ、蒼い風　強い日差し　いつか追い越して	これから描いて行く恋の色　始まりのページ彩るよ
二つ折りの白い地図に　記す小さな決意を	正直に今　伝えよう
光る滴として　降り注いだ	気がついたら　心の中　やさしい風が吹いて
いつの間にか　すきま空いた　心が満たされて行く	ふとした瞬間の　さり気ない仕草
幾つもの季節を通り過ぎて	たどり着いた　二人の場所　長すぎた旅のあと
いつの日にか　夢を語る　あなたの顔をずっと	見つめていたい　微笑んでいたい
抑えきれない　この気持ちが　25時の空から	光る滴として　降り注いだ
行き場なくした強がりのクセが　心の中で戸惑っているよ	初めて知ったあなたの想いに　言葉より涙あふれてくる
二人で歩む道　でこぼこの道	二つ折りの白い地図に　記す小さな決意を
気がついたら　心の中　やさしい風が吹いて	明日への扉　そっと開く
耳元で聞こえる二人のメロディー　溢れ出す涙こらえて	ありきたりの言葉　あなたに言うよ　「これからもずっと一緒だよね…」
大切な何かを守るとき　踏み出せる一歩が勇気なら	傷つくことから逃げ出して　いつもただ遠回りばかり
占い雑誌　ふたつの星に　二人の未来を重ねてみるの	かさぶただらけ　とれない心　あなたの優しさでふさがる
きっと　二人の距離　溶かしてくれる	信じていて
最後の言葉を今　静かに思い出せば	これでもうさよならじゃないけれど　ただ悲しいね
明日旅立つけど　別れだけど　春の木漏れ日が	きっと　二人の距離　溶かしてくれる
うつろな恋の弱さ　包む雪も今では	切ない別れの浅瀬に積もり消えて行く
二人　重ね合った　愛のしるし　明日へと刻んで	いつかまた会えるよ　抱きしめてね　ぬくもりだけ
吹きつける風が　遠くあたたかいね	そっと頬にすり抜け　別れのときかみしめた
いつかまた会えるよ　抱きしめてね　ぬくもりだけ	どうか忘れないで
いつしか青空　あの日の色みたい	眠い目でケンカして他愛もない嘘叱った
「ごめんね」言えないまま　遠ざかる瞳	また涙背負う　昨日より重い肩に散る
太陽いつもまぶしいけれど心照らせないね	私の見たことない現実(リアル)今あふれてる
夜明け前　雨が道に小さな水たまりつくる	昔のことを思い出している　まっすぐ歩いた気がしてる
言葉では足りないとわかっているけど　あきらめたわけじゃないよ	握ったこぶしはどこへ行くの?空へと伝えたい
昔のことを思い出している　まっすぐ歩いた気がしてる	自分らしさ失うことで何かを捨ててきた
白い花咲かせていた雨のない砂漠に	言葉では足りないとわかっているけど　あきらめたわけじゃないよ
答えだけすぐ求めてはダメなんだろう	雨しずく　大河となり海をわたって行く
雨しずく　大河となり海をわたって行く	届けたいものここにあるんだよ
小さすぎる手見つめるけれど　握り返すだけで	あふれてくる自分の矛盾今感じてる
あふれてくる自分の矛盾今感じてる	大切なものあるっていつでもわかっている
大切なものあるっていつでもわかっている	この太陽(ひかり)ここにある地球(すべて)を照らすけど
自分らしさ失うことで何かを捨ててきた	太陽いつもまぶしいけれど心照らせないね
テレビ見て笑いころげ　その後むなしくなるとき	小さすぎる手見つめるけれど　握り返すだけで
私の見たことない現実(リアル)今あふれてる	白い花咲かせていた雨のない砂漠に
この太陽(ひかり)ここにある地球(すべて)を照らすけど	幾千もの星たちは長い旅終えてこの大地(ばしょ)へとほら今帰って行く
私を待ってる人がいる	いい日旅立ち　幸福をさがしに
雪解け間近の北の空に向かい	過ぎ去りし日々の夢を叫ぶ時
私は今から想い出を創るため	砂に枯れ木で書くつもり「さよなら」と
岬のはずれに少年は魚つり	青い芒の小径を帰るのか
私を待ってる人がいる	いい日旅立ち　羊雲をさがしに
いい日旅立ち　羊雲をさがしに	父が教えてくれた歌を道連れに…
あゝ日本のどこかに	私を待ってる人がいる
私を待ってる人がいる	いい日旅立ち　夕焼けをさがしに
いい日旅立ち　幸福をさがしに	子供の頃に歌った歌を道連れに
いい日旅立ち　夕焼けをさがしに	母の背中で聞いた歌を道連れに…
帰らぬ人達熱い胸をよぎる	せめて今日から一人きり旅に出る
傷つけ傷ついたその証こそ愛を育てた誇れるしるし	手放したものは全部あなたが埋めてくれたね
あなたが笑うから私も笑う　永遠というこの瞬間に	世界が動くほどの奇跡を今も確かに感じているよ
どんなに離れても今なら言える　あなたのことを信じているよ	あるがままの2人でいい　そこから始まっていくよ
一緒に口ずさんだあの歌　同じ喜び	数え切れないほどのあふれる想い
これからも向き合うことを恐れないと誓うよ	あなたが笑うから私も笑う　永遠というこの瞬間に
いろんなことを積み重ねて運命に変わる	寒さも落ち着いてきたね　雲の切れ間に差し込む
数え切れないほどのあふれる想い	全てはあなたのためにできた
偶然だと思っていたさりげないあの出逢いも	いろんなことを積み重ねて運命に変わる
広く不恰好な背中にそっと投げかけたの	互いの孤独を渡しきれず疑うことに憤れた夜もあったけれど
思い出に過ぎなかった言葉がいつからかたくさんの意味を抱いた	あなたが笑うから私も笑う　永遠というこの瞬間に
寒さも落ち着いてきたね　雲の切れ間に差し込む	鈍くあたたかな光が2人を包んでる
鈍くあたたかな光が2人を包んでる	思い出に過ぎなかった言葉がいつからかたくさんの意味を抱いた
雪解けした朝　にじむ夜明け	一緒に口ずさんだあの歌　同じ喜び
あなたが笑うから私も笑う　永遠というこの瞬間に	どんなに離れても今なら言える　あなたのことを信じているよ
あたためて行く手のひらは結ばれているんだね	ねえあなたに逢えてよかった
互いの孤独を渡しきれず疑うことに憤れた夜もあったけれど	あなたが笑うなら私も笑う　永遠というこの瞬間に
か細い声でつぶやいた心からの「ありがとう」	広く不恰好な背中にそっと投げかけたの
世界が動くほどの奇跡を今も確かに感じているよ	あたためて行く手のひらは結ばれているんだね
ねえあなたに逢えてよかった	ずっとあなたのそばにいるよ
あなたが笑うなら私も笑う　永遠というこの瞬間に	傷つけ傷ついたその証こそ愛を育てた誇れるしるし
どうかもう一度会わせて　ここへ帰らせて下さい	でももう　これからはね　私が前を見るよ
帰らぬ日々をうらんでも　あなたは戻らないけど	せめてもう一度会わせて　他の何にもいらないよ
声が聞けない　顔も見れない　昨日までここにいたのに	もう話せない　電話もないよ　いつしか星になって
せめてもう一度会わせて　他の何にもいらないよ	でもきっと　思い出がね　帰れる場所になるよ
あなたは胸に生きてる　そう信じて歩き出す	さよならはずっと言えないよ　ほんとの別れじゃないよ
窓辺に寄り添った日も　明るく笑った日も	古びた部屋に眠ってる　あの日の笑顔も
流れる雲に想い寄せて　涙は見せたくないよ	あなたは胸に生きてる　そう信じて歩き出す
流れる雲に想い寄せて　戻れない場所で祈る	どうかもう一度会わせて　ここへ帰らせて下さい
優しく叱ってくれたね　ケンカしてそっぽ向いた日	心にしまったアルバム　写真が騒ぐの
いつか出会う楽園で　眠らない愛歌う	ずっとね　忘れないで　心は側にあるから
さよならはずっと言えないよ　ほんとの別れじゃないよ	いつか出会う楽園で　眠らない愛歌う
消えてしまった　愛しい人よ　今はもう遠い面影	だけど今でも 忘れてないよ　映画のような愛を
つまづいてもいいよ　立ち上がれるきっと	涙の数だけ道を越えていこう笑顔は忘れない
飛行機雲が今行く先示すから	砂時計は元に戻るけど僕は後戻りしないさ
心に風集め走り出そう世界をまたいで	飛行機雲が今行く先示すから
天使と悪魔　都会は今も光と闇　空に見えかくれ	この街は時に向かい風追い　この涙教えてくれるよ
1メートル先のゴールじゃ進めないよ	空に地図を書いてみよう君の持っているペンで
行き場をなくしても　居場所があるきっと	南の街がなぜかなつかしい　大人になったせいだね
この街は時に向かい風追い　この涙教えてくれるよ	昨日まで見えるのに　明日はかくれんぼ
南の街がなぜかなつかしい　大人になったせいだね	ねずみ色した空に僕の風飛ばしたいよ…
砂時計は元に戻るけど僕は後戻りしないさ	君と見つめていた約束の星つかむんだ
どんなに道が長くてもとにかく前へ行こう	つまづいてもいいよ　立ち上がれるきっと
涙の数だけ道を越えていこう笑顔は忘れない	心の中で走り出そうよほらあの風と…
かっこつけて隠すものはそんなに見た目よりダサくはないんだ	なくすものも多いけど　また次があるよ
昨日まで見えるのに　明日はかくれんぼ	太陽を知らない一番星になりたい
なくすものも多いけど　また次があるよ	1メートル先のゴールじゃ進めないよ
空に地図を書いてみよう君の持っているペンで	行き場をなくしても　居場所があるきっと
太陽を知らない一番星になりたい	心に風集め走り出そう世界をまたいで
空より澄んでるまなざしなんだね 君は誰より傷つきやすい人	大地に降る雨は心に溶けて 君と僕の明日になる
君と僕はここで出会った 少し寒い秋の夕暮れ	大切だと想える人がそばにいれば歩いて行ける
君と僕は夢を持つのさ 時の流れ逆らうように	精一杯の勇気出せるよ 涙ふいた君と僕なら
涙 笑顔 ふたつの心 人はみんな持ってるんだ	願い、迷い、希望、絶望 捨てる事は出来ぬ感情
生まれてきたもの、向きあってるもの すべていつか旅立つものさ	いとおしんで悲しんだら そこからきっと愛になるよ
いつか世界が壊れてしまえば こんな想いはもう持たなくていいの?	誰もがひとつになる事は出来ない 悲しいけど
「ありがとう」と「さよなら」の意味 きっといつかわかるはずだね	最後だけはあきらめないで 遠く近く君を見てるよ
いつも通る道で2人同じ気持ちなんだ	変わらぬ僕ら
君だけ覚えていたよね　うれしかった	キラキラキラキラ光る波しぶき
キラキラキラキラ光る波しぶき	僕たちを連れて行ってよ
よそ見してたら大切な君が泣いていたよ	おもちゃの気持ちじゃないから　僕がいるよ
1人になると淋しいつないだままの手	秘密の場所に一年中咲く花の名前
あの角曲がり2つ目　信号のわき	いつものポプリの店、少しあせた看板
おもちゃの気持ちじゃないから　僕がいるよ	キラキラキラキラ光る太陽に負けないように生きるんだ
ねえ暗くなる夕暮れの公園に行ったね	オレンジ色した町並み、2つの影
裏通りネコの多い家の前の道	1人になると淋しいつないだままの手
いつものポプリの店、少しあせた看板	一車線の車をかばうよう歩く
キラキラキラキラ光る宝石のように輝けたらいいね	このまま遠くまで走り抜けてく夕焼け雲
キラキラキラキラ光る太陽に負けないように生きるんだ	いつも通る道で2人同じ気持ちなんだ
秘密の場所に一年中咲く花の名前	君だけ覚えていたよね　うれしかった
僕たちを連れて行ってよ	ぼんやり空の下では雨上がり虹がかかる
一車線の車をかばうよう歩く	君との帰り道が僕は好きなんだ
心が加速していく　「好き」以上の気持ちだよ	全然無理みたいだね　大切な人　クラスメイト
夜空を流れていく　星くずのかけらひろうよ	全然恋にならない　憧れの人　友達未満
西向きのこの部屋にはいつも早い季節来る	青空　白い雲がなびき夕焼け色に染まっていく
コバルト色の空には少し早い秋予感	教室一番後ろの席　まるでやる気がでてこない
君の後姿にやわらかい風が遅れ毛をとかす	時々見せる笑顔　たまらなく「大好き」だから
季節のはざまでなぜか戸惑うみたいさ　僕みたいだから	指先でなぞる地図　行方しらずの恋は
全然近づけないね　クラスメイト	心が加速していく　「好き」以上の気持ちだよ
指先でなぞる地図　行方しらずの恋は	全然恋にならない一人よがり
教室一番後ろの席　まるでやる気がでてこない	君の後姿にやわらかい風が遅れ毛をとかす
卒業まではたった半年位しかないよ	全然近づけないね　クラスメイト
一番ほしかったもの　全部君が持ってたよ	一人じめしたいよクラスメイト　片思いさ
青空　白い雲がなびき夕焼け色に染まっていく	季節のはざまでなぜか戸惑うみたいさ　僕みたいだから
水色の風が吹いて　少し深呼吸をしたよ	西向きのこの部屋にはいつも早い季節来る
時間はどうもなぜだか早くまわっているみたい	コバルト色の空には少し早い秋予感
全然恋にならない一人よがり	夜空を流れていく　星くずのかけらひろうよ
時々見せる笑顔　たまらなく「大好き」だから	全然恋にならないクラスメイト
全然恋にならないクラスメイト	一番ほしかったもの　全部君が持ってたよ
君の笑顔が好きさ　君の全てが好きさ	この気持ち届けたいよ　君のもとへ届けたい
全然無理みたいだね　大切な人　クラスメイト	君の笑顔が好きさ　君の全てが好きさ
切れた文字跡に残る二人の悲しい運命	流れ落ちてゆく涙
軽い言葉さえ　見つからないなぜ？　こんなにも愛が答え探している	二人きりのせい　うまく話せない　時間止まれ心変えて忘れたい
窓の外見て　ほらもうすぐ終着駅が近づいている	街のネオンが今別れ風に消されてゆく
困った顔して　口開いたけど　こぼれた言葉が胸に突き刺さる	にぎった切符に　不機嫌な視線　帰りたい帰らない側にいさせて
くもりガラスに　小さく指であなたの名前書いてみたの	切れた文字跡に残る二人の悲しい運命
流れ落ちてゆく涙	濡れた唇かんだ
逆さまに過ぎ行く日常に　ガラクタばかり集めていたね	冷たく部屋に残ったものは　脱ぎっぱなしの嘘ばかりだね
黒い景色しか見えない	最後の二人きりね
もう一分だけ最後の	ワガママ聞いて欲しい
淋しがりやのあなたはもうすぐ行ってしまう	黒い景色しか見えない
街のネオンが今別れ風に消されてゆく	ぶっきらぼうな私は
開いたドアにあなたは足早に首振って降りたけれど	ここで降りたら本当に最後のホームになる
窓の外見て　ほら昔二人で行ったゲレンデが見える	淋しがりやのあなたはもうすぐ行ってしまう
ここで降りたら本当に最後のホームになる	もう一分だけ最後の
ぶっきらぼうな私は	あなたに合わないよね
ガラス越しに映ったあなたの　少しうつむき加減の瞳	動く電車の音「さよなら」が近づいている　ホーム離れて
あなたに合わないよね	開いたドアにあなたは足早に首振って降りたけれど
突然抱き寄せられた腕に　去年の夏と違う君の優しさ感じた	ブルーのシャツと水着が似合う　小麦色した素肌二人の夏色
なぜか思い出す　君と出会った日	言葉に出来ないよ　涙が思わずあふれた
もっと側にいて　ワガママなのかな?	「さよなら」言わさない　このまま魔法にかけたい
100年経っても今のまま一緒にいたいね	二人でいたこの海は　いつまでもつづいているから…
空からの天使　夢のような恋をくれたね	落とした白い貝殻　君のポケットにあったよ
真夏の星座が届きそうな空に溶けていく	君も見つめてるのかな?　ずっと前向きの未来を
どこまでもつづく　きらめく海が音を立てる	少し照れた瞳から　いくつもの「好き」見つけたよ
泣き虫だったね　君と出会ってから変わった	神様にもわからない　宇宙一の恋
おとぎ話みたいに旅して行きたい	空からの天使　夢のような恋をくれたね
青い空の下　世界中でたった一つの	君と三度目の夏　これから始まる
神様にもわからない　宇宙一の恋	100年経っても今のまま一緒にいたいね
君と三度目の夏　これから始まる	どこまでもつづく　きらめく海が音を立てる
夕暮れの浜辺　雲に乗ってどこかの島へ	おとぎ話みたいに旅して行きたい
もう会わないと決めたのに　どうしてそう勝手なんだ	忘れる自信がないと僕にはわかっていたけど
忘れる自信がないと僕にはわかっていたけど	眠れない夜　夜更けの窓に　思い出の雨降り出したよ
偶然だね　さよならの雨　忘れたはずの君がいたよ	混み合った車の帯に　見知らぬ秋風吹いてる
通り雨なんかじゃないさ　忘れられないものもある	西風に手を振ったけどこの愛は置いて行くから
赤い傘がよく似合う人　歩く足どり、なつかしい笑顔	頬濡らした雨の粒たち　今でも覚えてる
降り止まない雨の中で　頼りない自分がいるよ	冷たすぎるこの雨は涙も溶かしてしまうよ
つけたままのラジオからは　平凡すぎるニュースばかりで	足音が聞こえればつい振り返ってしまう
目印のない道を歩く二人	永遠と未来とが重なる　この瞬間にね
永遠と未来とが重なる　この瞬間にね	新たな扉　二人で開けるはず
幾千もの想いが夜空で　ほら溶けていくよ	目印のない道を歩く二人
あなたといつまでも　歌いたい	幸せのうた
一番の笑顔をあなたに　いつもあげたいよ	泣いたりしてもどんなにケンカしても
明日きっとあなたに言う　誰よりも「大好き」	幾千もの想いが夜空で　ほら溶けていくよ
やっと気づいた初めての勇気	言葉はいつも不器用だけど　ホントの気持ちは
いつも心にある　あなたとの	約束のうた
新たな扉　二人で開けるはず	あなたといつまでも　歌いたい
私の耳元に　聞こえたよ	はじまりのうた
あなたとこうして手をつないでいると小さな幸せ	失くしたくない　少しこわくなるのはなぜ？
最初の恋はとても臆病　そして優しいね	やっと気づいた初めての勇気
メールの返事待っていると　なぜか心切なくなる	たくさんの思い出を作ろうね　幸せな未来夢見て…
言葉はいつも不器用だけど　ホントの気持ちは	変わらないから　あなたを守りたいんだ
泣いたりしてもどんなにケンカしても	いつも心にある　あなたとの
あなたと出逢って最初に心からうれしく思った	時間の流れについて行きたいと思った
変わらないから　あなたを守りたいんだ	私の耳元に　聞こえたよ
離れた距離が不安になる　見上げる空も悩み色	いつの日か二人共に幸せになれますように祈るよ
クリスマスや誕生日のときも	一番の笑顔をあなたに　いつもあげたいよ
これから過ごす大切な日は　あなたといたいよね	クリスマスや誕生日のときも
まぶしい朝日の中入れるコーヒー　寝ている間に	あなたの寝顔とてもとてもあたたかい
今日はどこに行こう　あてもないままで	あたたかな午後の　街をゆらゆら
信号２つ越えて　大通りに出ると	車と自転車の　波が押し寄せる
桜咲いた公園の　ベンチに座り　のんびりと過ごした	明日も晴れるよね
小犬が川のほとり　散歩してるよ	気づかずにいた空の　あのくじら雲
春色の海辺　あなたと行きたい	次の日曜　約束してバイバイした
静かに暮れていく　変わらない街を	スキップしながら　歩いていくごきげんな日
思わぬ事態に　胸がドキドキ	駅前の本屋　二人立ち見して
ピンクのアイシャドウでメイクをしてみよう	お気にの服も着て　さあ出発だね
遅く起きた日曜　止めためざまし	春の光を浴びた　やわらかな朝
近所の喫茶店　ちょっと立ち寄って	たのんでみたよ　飲めるようになったコーヒー
少し切ないね　帰りたくない	春色の海辺　あなたと行きたい
あたたかな午後の　街をゆらゆら	近所の喫茶店　ちょっと立ち寄って
偶然会ったね　大好きなあなた	思わぬ事態に　胸がドキドキ
今日の帰り道　あなたと歩いた	少し切ないね　帰りたくない
何よりあなたと　会えてよかった	静かに暮れていく　変わらない街を
駅前の本屋　二人立ち見して	笑い合えたよ　今日の運勢大吉かな？
今日は楽しいね　すごくうれしいね	何よりあなたと　会えてよかった
きっといつか大空へと　胸を張って叫んでやる	せみの鳴き声が聞こえる　私もここで早く鳴きたいんだ
せみの鳴き声が聞こえる　私もここで早く鳴きたいんだ	汗もかいて　ホントの力を試してみたいんだ
探してた自分自身　やりたいことわからない	一つのことに熱くなる　かっこよさ教えて
大きな夢を焼き付けろ　熱い日差しをつくるこの大地に	まだ私は　自由と孤独のはざまで揺れている
くるくる回るこの地球は　重たいものたくさん抱えている	私も今　何かに押し流されて行く気がした
静かに今刻んで行く　確かな時間と足跡	大きな夢を焼き付けろ　熱い日差しをつくるこの大地に
道にはぐれたった一人　真夜中を旅しているよ	くるくる回るこの地球は　重たいものたくさん抱えている
まだ私は　自由と孤独のはざまで揺れている	15の夏
私はここで叫んでる　神様話をしよう	静かに今刻んで行く　確かな時間と足跡
運命とかきっとどこかにあるんだろう	信じても信じなくても　最後は自分で決めるよ
私はここで泣いている　神様助けてほしい	道にはぐれたった一人　真夜中を旅しているよ
私も今　何かに押し流されて行く気がした	15の夏
私はここで生きている　神様教えてくれた	きっといつか大空へと　胸を張って叫んでやる
汗もかいて　ホントの力を試してみたいんだ	15の夏
夏の青空が広がる時　何かが始まりそうな予感がする	昨日までの不安や悩みも　たぶん勝手な一人よがりだったネ
誰も予想つかないよ　動き始めた夢	無力と無知は昨日まで　一歩ずつ進もう
世界の片隅にある誰も知らない魔法をかけたい	明日まで降る雪の音をずっと二人で聞けるように…
今と同じように少し寒い夜だった　12月	空からほら舞い降りたかけがえのない贈り物この手に
この街はまた一つ二人の季節運んできたね	静かに足元見れば長い今年の月日の跡
ちぎれた雲差し込む光が優しい木漏れ日になったね	窓辺に並べたあの日の写真　思い出あふれてきた
静かに足元見れば長い今年の月日の跡	言葉より早くこぼれていく笑顔が一番好きなの
気まぐれな時間　動くことも忘れて　離れたくないから	世界の片隅にある誰も知らない魔法をかけたい
一番特別な恋だからきっと臆病になってた	あなたの優しさにひきこまれこのまま白い夢見るわ
覚えていないよね　最初に出逢った一年前のこと	今と同じように少し寒い夜だった　12月
繰り返した街はひときわオレンジ色に染められていく	赤色のサンタクロース　二人のもともうすぐ来るよ
言葉より早くこぼれていく笑顔が一番好きなの	冷たい風はまるで私をさびしがりやにさせる
空からほら舞い降りたかけがえのない贈り物この手に	はじめてつくるぬくもり来年もあなたに届けたい
窓辺に並べたあの日の写真　思い出あふれてきた	別れ話を本気にしないで　余計な意地はったの
別れ話を本気にしないで　余計な意地はったの	上手に言いたい嘘がつけないいつも　あなたが好きだから
上手に言いたい嘘がつけないいつも　あなたが好きだから	一番特別な恋だからきっと臆病になってた
冷たい風はまるで私をさびしがりやにさせる	涙色してる冬空の星よ　どうか願い叶えて
涙色してる冬空の星よ　どうか願い叶えて	気まぐれな時間　動くことも忘れて　離れたくないから
心の駅に　君がきっと待ってる	ドキドキするよね
初めてだよ　こんな気持ちになるの	戸惑ってる
誰にも見えない　ビルの間に	ほら静かな銀河の群れ
いつも見つめている　青い空と君の横顔	僕のポケットに　ギュッとにぎった手が
僕がここにいるから	明日からも歩ける
夜空見上げた　星が一つ流れて	二人の気持ちを運んできた
素敵だね	いつも見つめている　青い空と君の横顔
小さく息をひそめてる	大好きだよ　君の意地っ張りさが
大好きだよ　君の意地っ張りさが	特別だよ　君がくれる一瞬
大事なものができて	誰にも見えない　ビルの間に
特別だよ　君がくれる一瞬	朱色の街角　キミが走って笑顔くれた
朱色の街角　キミが走って笑顔くれた	たまらないよ
晴れた海には　船が白波立てる	キラキラ揺れるよ　二つの影
君がそばにいるから	僕がここにいるから
嬉しいよ	あの日　君が言った言葉
ドキドキするよね	終着駅
歩こう	未来が迷い道になっても
あの日　君が言った言葉	泣きながら聞いていた
キラキラ揺れるよ　二つの影	いつか夢より　たくさんの空を見て
戸惑ってる	大事なものができて
泣きながら聞いていた	初めてだよ　こんな気持ちになるの
ずっと心にとめどなくある不安	君が消してくれたね
未来が迷い道になっても	君がそばにいるから
二人の気持ちを運んできた	ずっと心にとめどなくある不安
僕のポケットに　ギュッとにぎった手が	小さく息をひそめてる
いつか夢より　たくさんの空を見て	二人の雲　浮かべよう
終着駅	歩こう
だからいつの日か思い出がね　輝けるように	例えば笑って「あばよ」と手を振ればどんなにいい？
いくつもの日々を重ねていたけど	どうしてすれ違ってきたのだろう
どうしてすれ違ってきたのだろう	分かち合った愛と夢は　幻だった？
波音が近づく　熱い渚よ	淋しげな影だけ残して終わった
どんなに心変わりしても　あの日々は忘れない	どうかこの恋が消えぬように　祈っていて欲しい
あなたの香りが今も私　抱きしめているよ	あなたがまだこんな私にも　笑ってくれるのなら
例えば笑って「あばよ」と手を振ればどんなにいい？	一人のあなたを私はまだ　愛しているから
あきらめたわけじゃない本当は　あなたを想っているの	だからいつの日か思い出がね　輝けるように
夜に隠してほしかったのになぜ？	きれいな月　今日も照らす　海の調べ
永遠という言葉じゃないよ　約束もないね	どんなに心変わりしても　あの日々は忘れない
あの夏の陽射しが　焼きついたまま	別れを知るこの恋　夜をさらっていく
夏の幻は二人の恋　海辺の物語	永遠という言葉じゃないよ　約束もないね
いつから私は弱くなった？　強さが何と知らず	あなたの香りが今も私　抱きしめているよ
閉じたページに今　隠された人	花火が散るように　切なさが染みる
泣いても誰もいない一人きりで	夜に隠してほしかったのになぜ？
あなたがまだこんな私にも　笑ってくれるのなら	たった一つだけあの言葉も　うそなんかじゃない
苦しいときにいつも一人と　気づけなかった近すぎた愛	ワガママだけどそばにいたいのよ　他愛もない話をしていたい
今日の日のことずっと忘れない　形にならないこの気持ち	たくさんの涙から生まれたよ　大切な人と歩んでいくよ　これから
涙があとからあふれ止まらない	大好きな人達に「ありがとう」と「さよなら」
生まれた奇跡　出逢えた奇跡　この大きな青空の下で	子供のときはよく泣いていた　やわらかい手いつも握っていたね
「ありがとう」の言葉はいつもなぜか素直に贈れなかったけれど	心から今はここで伝えたい　難しい人生でも一人じゃないね
いつのまにか大人になったんだ　だけどあの時と吹く風は変わらない	苦しいときにいつも一人と　気づけなかった近すぎた愛
心から叫びたい「ねえ今幸せだよ」	願うものならば遠くまであなたと一緒にはばたきたい
心から今はここで伝えたい　難しい人生でも一人じゃないね	生まれた奇跡　出逢えた奇跡　この大きな青空の下で
人はいくつもの愛を数えては　数えきれない想いつくる	涙があとからあふれ止まらない
ワガママだけどそばにいたいのよ　他愛もない話をしていたい	ほら目の前を見て　真っすぐの光が　今この場所を包んでいる
大好きな人達に「ありがとう」と「さよなら」	変わらない私でいるよ
ほら目の前を見て　真っすぐの光が　今この場所を包んでいる	私は歩き出せるはずあなたと　嬉しいときも悲しいときも
子供のときはよく泣いていた　やわらかい手いつも握っていたね	今日の日のことずっと忘れない　形にならないこの気持ち
電信柱の上流れる雲　見つめてはただ追いかけていた	いつのまにか大人になったんだ　だけどあの時と吹く風は変わらない
輝く星が願う夢一つ　2人の行く先予感させてる	いつしか2人は魔法にかかり　冷めぬ夜更けは長くて深い
昨日も今日も明日もあさっても　ずっと一緒に過ごしたい	生まれ変わっても君の隣で　永遠の道を歩きたい
愛なんて言葉　知らずにいたよ　待っている明日はどんな色?	さまよう星が照らす夢乗せて　未知の2人信じて歩みだそう
涙も痛みもこの腕に分けあいたい	夜空に浮かんだ2つの星が幻という名の殻を破り
幾千もの時を重ねて今　光にとけ合い一つになった	終わらない愛を確かめてこの手を離さない
側において優しい風耳元で感じている	時に不器用で　時に意地っ張りで　傷つけたりもしたけど
さまよう星が照らす夢乗せて　未知の2人信じて歩みだそう	これから奏でる2人のメロディー　どんなものよりも甘くて苦い
時に不器用で　時に意地っ張りで　傷つけたりもしたけど	愛なんて言葉　知らずにいたよ　待っている明日はどんな色?
いつしか2人は魔法にかかり　冷めぬ夜更けは長くて深い	こんなに人を愛することもう二度とできない
夜空に浮かんだ2つの星が幻という名の殻を破り	幾千もの時を重ねて今　光にとけ合い一つになった
冷たい頬ぬらすようにあたたかい手も待てない	昨日も今日も明日もあさっても　ずっと一緒に過ごしたい
変わらないその笑顔が誰よりも愛しくて	冷たい頬ぬらすようにあたたかい手も待てない
今はただその瞳が離れてしまわないように	側において優しい風耳元で感じている
生まれ変わっても君の隣で　永遠の道を歩きたい	輝く星が願う夢一つ　2人の行く先予感させてる
これから奏でる2人のメロディー　どんなものよりも甘くて苦い	戻らないこの一瞬をずっと大切に贈るよ
過去となった時間を今に戻せたら…	上手に生きる道は選ばない　空回りはつきものね
上手に生きる道は選ばない　空回りはつきものね	でも裸のまま見えない　勇気一つだけを
真実はいつも一つだけれども　道は二つ以上ある	大切なものを守りたいんだ　ただそれだけ
でも裸のまま見えない　勇気一つだけを	この手に握りしめて　ひたむきに歩きたい今は
大切なものを守りたいんだ　ただそれだけ	一回、一瞬でも　精一杯の花咲かそう
弱さ　すがりついても　また前を見るよ	時に空を見上げて想うの　こんなちっぽけな私
思いがけないこと　目まぐるしくあった	1人で泣いた夜越えてわかったの
人はなぜ何度も同じ道を歩むの?	過去となった時間を今に戻せたら…
時に空を見上げて想うの　こんなちっぽけな私	だけど後悔はしたくないから
だけど後悔はしたくないから	迷わないで　真っすぐ突き進もう　違う場所でも生きるよ
鏡にうつった目に　涙は似合わないね	真実はいつも一つだけれども　道は二つ以上ある
1人で泣いた夜越えてわかったの	人はなぜ何度も同じ道を歩むの?
自分の歩く道に言い訳はしないから	弱さ　すがりついても　また前を見るよ
強がりのない心もきっとない	自分の歩く道に言い訳はしないから
嘘をつかない世界なんて存在しない	強がりのない心もきっとない
あの日からもう私　一人で歩き始めたの	忘れかけていた街並み　心の時間に問いかけた
今このときを越えればもうすぐ笑えるから	いつもあなたを想っているよ　かっこつけないで
うまくはいかなくても人生にルールはない	あなたらしく歩けばいいよ　未来に向かって
あなたはどうしてる?くじけそうになったりしていない?	ほら空を見上げてみて　大人の瞳になったね
二つの足でそっと歩いてきた長い道は	曲がり角も増えたけれど　大切な真実
もし世界が終わってもあなたの手にある花は	きっと咲きつづける　それだけ忘れないでいて
曲がり角も増えたけれど　大切な真実	あなたはどうしてる?くじけそうになったりしていない?
人は弱いものね　守りたいものが守れなくて	でも生きることは強い　自分にしかできない
ほら空を見上げてみて　大人の瞳になったね	もう自分はダメなんて絶対思わないで
人前では見せない涙はきれいだから	うまくはいかなくても人生にルールはない
忘れかけていた街並み　心の時間に問いかけた	二つの足でそっと歩いてきた長い道は
きっと咲きつづける　それだけ忘れないでいて	だから2人の花咲かそうよ　今この場所から…
でも生きることは強い　自分にしかできない	人前では見せない涙はきれいだから
あふれてくる想いを言葉にできなくても	そう私がそばにいるから　迷わなくていい
もう自分はダメなんて絶対思わないで	今このときを越えればもうすぐ笑えるから
泣き虫な私から　ここまで数えてきた明日	何かを捨てる勇気を知って変われたんだ
何かを捨てる勇気を知って変われたんだ	人は弱いものね　守りたいものが守れなくて
そう私がそばにいるから　迷わなくていい	もし世界が終わってもあなたの手にある花は
帰り道ファーストフードに寄って　よく見つかって先生に怒られたね	青い空、仲間と流す汗　飲みかけのジュースを分け合った
ほら泣かないで　また昨日みたいに　集まって笑い合えればいい	大人になる　まだよくわからない　でもきっと今より強くなるんだ
修学旅行　京都の夜に　君を呼び出して告白したけど	答えはきっとわかっていたよ　気持ち抑えきれなかった
未来語り寄り道して　一つの空見つけた	校庭の風、日焼けした椅子に　あの子と並んですわっていた日々
教室に詰まっていた青春という名の粒	最後のチャイム　思わず涙あふれてきたよ
校庭の風、日焼けした椅子に　あの子と並んですわっていた日々	「ちょっと高嶺の花だよ」なんて笑われてあきらめかけた
答えはきっとわかっていたよ　気持ち抑えきれなかった	いろんな季節を刻んだ校舎の　思い出たちに僕らのにおいをつけた
遅咲きの桜、裏道の店、自転車で追い越した夏の夕日	未来語り寄り道して　一つの空見つけた
「ちょっと高嶺の花だよ」なんて笑われてあきらめかけた	帰り道ファーストフードに寄って　よく見つかって先生に怒られたね
最後のチャイム　思わず涙あふれてきたよ	逆らっていたけど今日だけはただ抱き合いたい
青い空、仲間と流す汗　飲みかけのジュースを分け合った	消えてしまう街影に一番星を見つけたよ
駆けていくグランド、白いシャツ　探してた忘れ物、教科書も	落書きでうめたノート　小さな夢がかくれてた
いろんな季節を刻んだ校舎の　思い出たちに僕らのにおいをつけた	駆けていくグランド、白いシャツ　探してた忘れ物、教科書も
不思議だよね　今の方がキミを	出会った頃より　大切に想っているよ
ヒマできたらまた今度　いつものカラオケに行こう	流行りの映画も見たい　約束だよ
あの日の手紙　書いてくれてありがとう	ちょっと照れくさい　僕の想いも届けたい
だから泣きたくなったときは　いつでも電話待ってるよ	キミは誰より淋しがりやだね　ほっとけないよ
いつか大人になったときも　今のままで過ごしたいね	時にはどこか旅行にも行って　また夜明けまで語り合おうよ
昨日キミはすごく悩んでいたね	必要なときに　そばにいれなくてごめんね
二人の持っている夢　まだ遠いけど	絶対あきらめないで　きっと叶えられるから
朝まで語り合ったネ　制服のまま二人で	渋谷のネオンが消えて　さよならした
だけどいつでも　君のその笑顔 変わらない宝物	心揺れるよ　涙は優しい嘘だから
ずっと　2人の距離　夢見た明日より遠すぎるね	だけど　あの日の夢　幻じゃない燃え尽きた花よ
だけど　あの日の夢　幻じゃない燃え尽きた花よ	もう一度　側にいたい　壊れた愛直して
昨日に戻ったヒカリ達　たたずむ街の風に抱かれて	あの時見た夢を信じ　長い旅路進んで行こう
君は今どこ? 何してるのかな? 遠い夢へ帰って	いつか届けて　この想いがあふれて行くよ
広がり瞬く星空に　一つの夢が舞い降りた	何が幸せなんてずっと　答えの出せない面影だから
明日を導くヒカリ達　壊れるくらい胸にあふれて	広がり瞬く星空に　一つの夢が舞い降りた
何が幸せなんてずっと　答えの出せない面影だから	それよりただ前を見て　焦らずに歩んで行こう
もしも　叶うのなら　君のそばで永遠を歌うよ	いつか　この場所から　もう一度愛を取り戻したいよ
いつか　この場所から　もう一度愛を取り戻したいよ	何もない鳥かごの中で　早く抜け出せたら
今日はみんなが「おめでとう」って言ってくれた	拍手と笑い声が二人をつつんでくれた
『ホントに私でいいの?』びっくりして聞いたんだ	「俺が、幸せにするから。」
拍手と笑い声が二人をつつんでくれた	『私、幸せになるから。』
銀色　交わした指環　とても、とてもキレイだね	二人で明日への扉を　そっとそっと開こうね
下北沢のファーストフード　雨の日見た渋谷の映画	出会った頃を思い返した　少し照れていたあなたと私
忘れてないから　あの言葉も	強く、強く抱きしめられながら「大事な話がある」って言われた
思い出詰め込み　家を出るよ	白い、白いドレスにつつまれながら　この階段を一つずつ登った
二人で明日への扉を　そっとそっと開こうね	『ねぇ、幸せになるんだね』
やっとたどりついたね　約束の日	思い出詰め込み　家を出るよ
忘れてないよ　はじめて交わしたキス	忘れてないから　あの言葉も
「これから先　一緒に生きて行こうよ」	『ホントに私でいいの?』びっくりして聞いたんだ
突然 涙がほら　こんなに溢れてきたよ	ありがとう、ありがとうの想い　体中に満ちて行く
すきすきすきすき　すき　すき	あいしてる
だけどかおは　ざんねんだよ	さんきゅうひん
あいしてる	すきすきすきすき　すき　すき
だけどけんかは　からっきしだよ	さんきゅうひん
こころはやさしく　いっきゅうひん	おつむはくりくりだよ　いっきゅうひん
とんちはあざやかだよ　いっきゅうひん	どきょうはまんてんだよ　いっきゅうひん
いたずらきびしく　いっきゅうひん	だけどけんかは　からっきしだよ
きにしない　きにしない	きにしない　きにしない
きにしない　きにしない	のぞみはとおく　かぎりなく
とんちんかんちん　とんちんかんちん	きにしない　きにしない
おつむはくりくりだよ　いっきゅうひん	おめめはかわいく　いっきゅうひん
どきょうはまんてんだよ　いっきゅうひん	いたずらきびしく　いっきゅうひん
わからんちんども　とっちめちん	とんちんかんちん　いっきゅうさん
アー　アー　なむさんだ	とんちんかんちん　とんちんかんちん
いっきゅうさん	いっきゅうさん
さんきゅうひん	アー　アー　なむさんだ
のぞみはたかく　はてしなく	わからんちんども　とっちめちん
すきすきすきすき　すき　すき	いっきゅうさん　いっきゅうさん
のぞみはとおく　かぎりなく	わからんちんども　とっちめちん
すきすきすきすき　すき　すき	いっきゅうさん
きにしない　きにしない	のぞみはたかく　はてしなく
おめめはかわいく　いっきゅうひん	だけどかおは　ざんねんだよ
変わらぬ愛を伝え続けるよ	信じる気持ちが何より勝って
このままずっと　ふたりで歩こう	目の前の道が見えなくなっても
数えきれない感謝がいっぱい	歩いてきた道にあふれていたよ
その手にいつも温もり感じながら	新しい日を導いてくれる
この世界にあなたがいてよかった	あなただから全部の気持ちが
ありつづけてく“決心”をくれた人	いつも共に道を歩んでいく人
真っ白なベールの向こう	あなたと見た世界は　とても優しい景色
あなたに貰った　幸せのしるし	特別になる　私の左指
何があっても　この手　離れない	この手は　ずっと　ずっと離れない
愛が見えたよ　愛が見えたよ	このままずっと　ふたりで歩こう
歩いてきた道にあふれていたよ	絶対にね　この手　離さない
目の前の道が見えなくなっても	絶対にね　この手　離さない
あなただから全部の気持ちが	すなおに　まっすぐに動くことができるよ　いつも
“ずっと一緒”を誓い合ったふたり	夢のような　ほんとの話
新しい日を導いてくれる	“ふたり一緒”を守ってきてくれたんだね
まぶしい日差しと　優しく差しだす	ふんわりとした　大きなあなたの
絶対にね　この手　離さない	この手は　ずっと　ずっと離さない
背中あわせの狭いベッド	まぶしい日差しと　優しく差しだす
何年先も　何十年先も	変わらぬ愛を伝え続けるよ
信じる気持ちが何より勝って	何があっても　この手　離れない
愛が見えたよ　愛が見えたよ	数えきれない感謝がいっぱい
眠れない夜を何度重ねたろう	背中あわせの狭いベッド
あなたと見た世界は　とても優しい景色	あなたに貰った　幸せのしるし
あなたは一生わたしの心に	ありつづけてく“決心”をくれた人
もしも君のとなり　この手が離れたときは	見失わないように　きっと　むかえに来てね
それでも不安な夜は　訪れるものだからね	そんなときはギュッと　大げさに抱きしめていて
かけがえのないもの　君がたくさんここにくれた	だけど　何よりも　いちばん　かけがえのないものは君なんだ
2人歩むスピードは　きっと同じはずじゃないからね	もしも君のとなり　この手が離れたときは
2人の目の前　謎めきひろがった　未完成な地図	でも　とても　とても　心動いた…
どんな言葉　並べてみても　語りきれない想い	この愛が　ささやくよ　愛しさの意味を
“大嫌い”なんて　ウソでも言わないけど	“大好き”だって　ウソなんかじゃ言わないからね
2つの愛が離れてしまわないように　1つに抱いてて	それでも不安な夜は　訪れるものだからね
会えない時間(とき)さえ君は　何も考える余裕もないくらい	この心を　ひとりじめにするんだから
果てないアイノコトバ　あなたのそばで見つけてたい	言葉を届けたいあなた　大切なあなたがいる
世界中の愛の歌　すべてを歌ったとしても	伝えきれないほどの“ありがとう”が溢れてるよ　今
こんな風に笑えるのもあなたがここにいるから	その声もその瞳も私の支えとなる
言葉を届けたいあなた　大切なあなたがいる	それが私のすべてだから
途切れないアイノコトバ　あなたにいつも届いてますか？	この先変わらない真実(ほんと)の言葉だけを伝えたい
どれくらいの時間(とき)と距離をここまで共に来ただろう	かけがえのない記憶辿れば　いつもあなたがいます
終わらないアイノコトバ　あなたのそばで見つけてたい	あなたの心へと届く言葉を今日も歌ってます
繁いだ手に愛を咲かせて　君を信じてゆく	果てない想いを抱きしめ　君のそば「ねえ　幸せだよ」
愛の花　枯れぬように　そう君の光になりたい	儚い春も　焼けつく夏も　切ない秋も　凍てつき堪えてく冬も
繋いだ手に愛を咲かせて　君を信じてゆく	大切な物をこれからも　いつまでも君と見つけたい
部屋中切ない香り埋め尽くすよ　午前2時独り	君の声が聞けないだけで　こんなに弱くなる寂しくなる
君の隣でなら　深く大きく深呼吸ができる	君の温もりが　心にある大事な場所に届くよ
両手が届かない夜にも　君を信じてゆく	いつか君に「僕の全て」と言ってもらえる私になりたい
人は誰も見えぬ涙　胸の奥に抱えてる	立ち止まらなきゃ分からぬ景色があるから
同じ痛み寄り添いあうことができる君だから	同じ喜びをずっと分かちあえるんだ
痛みたちは確かに何かの意味を持って	そう僕らを必ず強くしてくんだ
握りしめた苦難たち　それを背負う覚悟決め	自由にした両手でこそ人を支えられる
悲しみ苦しみ　それを乗りこえた	時間(とき)の向こうで心支えるものに変わるようにと
生まれ変わるなら　また僕でいたい	いびつな生き方だけどね　君に出会える運命なら
果てしないエナジー	この先
強く立ち上がって	駆け出しはじめてく僕を信じて
君は何色に見えるの？	人は列をつくって　目を伏せて歩く
そのプライドにかけてもう一度	強く立ち上がって
勝ち残るのはクールでタフな人らしい	たとえば僕が安心できる居場所
他人(ひと)にどう見えても	ひとつ前の自分に勝っていたい
願い叶うことなんて　ほんの一握り	だったら　ひとつ　つかんだチャンス
夏に向かう太陽　僕の心まで1℃ずつ	あおり　急かしてゆくよ
たとえば僕が安心できる居場所	どこにあるのでしょう
張り裂けそうな胸を突きだし	こんな場所でおわる
赤く熱い鼓動	それは自分だけしか聞こえない
この先	願い叶うことなんて　ほんの一握り
みなぎる力の行く先決めた	他人(ひと)にどう見えても
こんな場所でおわる	僕じゃないってことを伝えたい
それは自分だけしか聞こえない	孤独　その痛みさえ
赤く熱い鼓動	張り裂けそうな胸を突きだし
赤く熱い鼓動	みなぎる力の行く先決めた
赤く熱い鼓動	そのプライドにかけてもう一度
孤独　その痛みさえ	僕の鼓動を速くさせてくんだ
人は列をつくって　目を伏せて歩く	この時代
あおり　急かしてゆくよ	果てしないエナジー
僕じゃないってことを伝えたい	赤く熱い鼓動
この時代	勝ち残るのはクールでタフな人らしい
街の空は歪む	君は何色に見えるの？
だったら　ひとつ　つかんだチャンス	すべてそこに注ぎこめ
あの日見つけたよ　君に見せたい未来	そして君を離さないと誓った
旅の中“影　光”“寒さ　暖かさ”も“別れ　出会い”	全て受け入れるなら恵
涙と笑顔の向こうに僕らの明日が必ずそっと光る	いつかその想い忘れそうな時はこの歌を思い出そう
そして誰かと想いが重なり合えた瞬間	愛が見えるよ
辛くても　ためらう　耳を今すませて	想いを吐き捨てる　場所をここに見つけて
夢をめぐらせてね　奏で合っているから	独りきりじゃいられそうもないときには
そして誰かの声をその胸に受けとめ	想い寄せ合ってゆこう
現実をのせてね　響き合っているから	辛くても　ためらう　耳を今すませて
私たち手にした12の音階が	夢をめぐらせてね　奏で合っているから
独りきりじゃいられそうもないときには	この音を頼りに　気持ちをたぐりよせて
私たちてにした　12の音階が	現実をのせてね　響き合っているから
銀杏並木2人歩く	眩しさと季節感じて歩くこんな自分に少し驚いた
銀杏並木2人歩く	腕絡ませ軽かやなに1年が過ぎてその先も変わらない想い
黒の折りたたみ　その傘はバス停までの道を	何度歩いてあなたを待ったかな
軽く背中叩く人　ふと振り向くと	やっと出会えた晴れた日曜　胸の高鳴りが聞こえた
銀杏並木2人歩く	そっと歩幅を落として一歩一歩恋のシャッターを切ってゆく
雨降りの朝のバス停　切れ目ない列	傘を忘れた私にさしだしたあなた
熱っぽく胸の奥が弾けはじめる	深まってく2人のコト願っている私がいた
あなたから笑顔こぼれてちょっと照れてる	その表情(かお)に不思議と心和んでゆく
あなたの空を見る瞳が綺麗　見とれて時間が止まった	木枯らしが吹いていたけど何故か心地よい春の風を感じた日
閉じる瞳　そこに潜んでいる　刹那い答え	体中が痛いのよ　欲望は果てなくて…
永遠の中　深く堕ちていきたいから	はやく　ためしてみて　きつく　体がおれるほど
体中が痛いのよ　欲望は果てなくて…	震える夜　誰かの体温　体中刻んでいたかった
失うわけにいかないのよ　狂わせないでいて…	うずく心　崩れはしないけど　激しく暴れるの私を
探ってみるの　魂の奥底を　この愛のすべて	失うわけにいかないのよ　狂わせないでいて…
かまいはしない　だから僕らは手をつないで	翼貸し合い　ぬくもりを知ってゆくよ
優しいほどの「繋がり」というモノにね	ほら変わってゆくとこうして気付いて知るよ
綺麗なモノ探し　美しいモノへと	こだわり夢を見た　でもね真実は
大事な心を削るしかなくて嘆いた	傷負った僕の心を君が舐めて気付いたんだ
大事なコトを知るためにね	大事な心を削るしかなくて嘆いた
かまいはしない暗闇避けて通れる場所なんて	どこにも誰にもないと知ったよ
何も見えて来やしなかった	キリがないほどの矛盾背負ってしまったみたいだね
こだわり夢を見た　でもね真実は	何も見えて来やしなかった
傷負った僕の心を君が舐めて気付いたんだ	僕は愛をね手にしてた
長い坂道をのぼるような毎日	辿り着く先も見えず
悔しさの上に何度も立って歩き出す	力へと変えてきた　そうあの日だって
愛も夢も何も手放したくない	大きく鳴らすよ“これが私”という証
夢と一緒に擦り減り泥まみれのあのブーツ	ずぶ濡れの中折れてしまったヒール　こうして探してきた世界
私が選んだ靴で残した足跡	ガラスの靴をいつかこの手にして
ガラスの靴をいつかこの手にして	私だけにしか歩けない道を行くんだ
私が選んだ靴で残した足跡	私らしく刻んで来れたのかな
間違い迷うたび見つけてきた道	悔しさの上に何度も立って歩き出す
大きく鳴らすよ“これが私”という証	靴音を響かせて
私だけにしか歩けない道を行くんだ	そしてきっと夢見た階段をのぼる
私が選んだ靴で残した足跡	間違い迷うたび見つけてきた道
しゃがみ込みたくなるような不安に負けないように	憧れや願いこの足に込めて見えぬ道を開いていく
恋と一緒に色褪せたあのサンダル	消えない傷のついたスニーカー
転んでもその傷が癒えたら　今よりもっと強くなれる	受けた向かい風　追い風にして　繰り返す痛みの中宿る光
踏み出す歩幅にルールなんてものは無くて	信じてきた答が道標になる
私が選んだ靴を並べては思う	愛も夢も何も手放したくない
私らしく刻んで来れたのかな	踏み出す歩幅にルールなんてものは無くて
教えてくれたね	君の優しさに何度救いを
こんなにも君がくれた愛だから	月が嘆く夜にうずめるときは
あたたかい涙があることを	君に出逢って知ったよ
憎んだ弱さも　それさえ	心を通わせ合う大切な感情(モノ)
こんなにも君がくれた愛だから	黒い太陽にたたずむときは
信じれるものがここに見えなくて	何もできず　ただ強がった
こんなにも君がくれた愛だから	二人に広がる空に誓うよ
君とは過ぎゆくものごとすべてが	かけがえのないほどに愛しく
色褪せないで　賞見期限のない	忘れられないようなメモリー
遠くの何処かへとつながる	熱い風を肌に感じて
太陽のきらめき　海の輝き	空の色のまぶしさや
魅せられて癒されてる時間(とき)が	教えてくれた　あたりまえと
教えてくれた　あたりまえと	思ってた　かけがえないものを
空の色のまぶしさや	いつもとなりにある君のその笑顔もそうなんだ
これ以上ない甘い太陽は	とても熱く光るメモリー
ピンクの夕映えに思わず	魅せられて癒されてる時間(とき)が
聴こえてくるよ心を揺らして	熱い夏を告げるメロディー
たったひとりの君と　巡り会う奇蹟に	心から溢れてる“ありがとう”
声が届く　見つめ合う　触れ合う　愛の音	ひとつひとつ送ろう　君と一緒に　戻らない時間を大切に
温かく大きな手に引かれて	楽しげに歌う　あの日の姿
胸いっぱい　優しさが　溢れきらめいてる	そう　みんなが　私の生きるアルバム
目の前の笑顔が　あまりに美しくて	心から溢れてる“ありがとう”
声が届く　見つめ合う　響くよ　愛の音	ひとりひとり贈ろう　君に贈るよ　また会える時間を信じて
そう　みんなが　私の生きるアルバム	今日の笑顔　忘れないよ
そう　今では温かく多くの	愛の中で精一杯　歌う姿
この世界の　この場所に生まれて	そのすべてに感謝したい
ねぇ　そのたび思うんだ　君がね	ここに生まれたことにも感謝したい
目が合って　かたまって	このまま動けなくなってもいい
君と続きを描き足したい	死んでも忘れられないくらいの
キラキラ星の下の君と	目が合って　かたまって
描きためた朝焼けのスケッチ	君と続きを描き足したい
悲しい思い出よりも	鮮明な笑顔と　鮮明な言葉を
鮮明な笑顔と　鮮明な言葉を	鮮明な記憶にして残すよ
鮮明な記憶にして残すよ	君の心(なか)に
達成しようとしては	生きてくほど
生きてくほど	守りたいものさえ定められず
君の心(なか)に	僕がねずっとずっと
果て知らず眩いほど輝ける	故　苦しいほど汚れ絶望を見る
悲しい出来事や　悲しい面影や	悲しい思い出よりも
求め生きようと　持ち合わせようと	達成しようとしては
人として同時に僕ら	求め生きようと　持ち合わせようと
そう　僕たちは	果て知らず眩いほど輝ける
人との違いと　人と一体感を	人として同時に僕ら
ただそばにいるというだけでもう充分だから	去ってしまわないようにと祈りながら眠る…
君への想いをうまくは言い表せないけど	君とだから過ぎ行く毎日に意味があるよ
雨が止み曇った心に	届いた思いもよらない贈り物
覚えていてほしい	君がどんなにやさしく肩を抱きよせたか
夢見てたことがひとつずつ	現実へとなっていくよ 強い愛だから
現実へとなっていくよ 強い愛だから	雨が止み曇った心に
次の夏も君と	夜の空に彩めき咲く 輝く花火を
夜の空に彩めき咲く 輝く花火を	見れるのかな 見れるよね その次の夏もずっと
初めての君と見る夜空	眩しくて 強く 果かなく 咲き輝いてた
眩しくて 強く 果かなく 咲き輝いてた	そうまるで二人の間に
そうまるで二人の間に	生まれ咲いた恋みたいだったよ
何度だって聞きたいよ	君への想いをうまくは言い表せないけど
君がどんなにやさしく肩を抱きよせたか	そして私が握りかえした手のつよさを
探したい　見つけたい	辿り着くまで　あと少し
二度と会えない場所へと	決して一人でね行かないと約束して
二人しか知らない隠れ家を見つけようね	風のない海で抱きしめて　君だけを信じてるの
あの頃に聞いて　憧れた物語は	君と私の　きっと君との…
鳴り響く風の中ぐっと　祈るよ	君との出逢いが心の傷跡をもうふやすことのないように
風のない海で抱きしめて　君だけを信じてるの	あの頃に聞いて　憧れた物語は
風のない海で　抱きしめて	二度と会えない場所へと
光の降る朝へと舟を出すよ	道しるべを君との　「ねぇ　証にして」
風のない海に願いかけて　どうか辿りつきたいよ	二人しか知らない隠れ家を見つけようね
眠る街を抜け　願いかけて　君の空色づく頃	心の小さな鍵を渡しに行くから
独りじゃね　こんな私はちっぽけすぎるものだから	君の中　ひたすらにね　私を映してるの
風のない海で　抱きしめて　どうか与えてほしいよ	いつかに失くして憧れた　物語を
ふたつの心に宿る　ひとつの想いを	風のない海で　抱きしめて
君に映る姿が　ただ唯一の	私の居場所探す　「ねぇ　頼りなんだ」
風のない海に　願いかけて　ひとつだけ叶えたいよ	ふたつの心に宿る　ひとつの想いを
カラフルな想いこの胸にしまい込む　夢心地でうたた寝	記憶の隅　聞いた君の吹く口笛で君色に染まる
カラフルな想いこの胸にはじけ飛ぶ　白いカーテン開ければ	街並みが光り　素敵なざわめきが聞こえてくるよ
黄色い日差し　スマイリーな君　今日はきっと楽しい日になる	赤い車にお気に入りソング　ミルクティー乗せて　さぁ行こう
駆け抜ける世界何色にも輝き　喜びに溢れてる	これからも君の隣に身をまかせ　どこまでも行くよ
息ひそめ　そっと横顔に見とれてた　君だけが輝くよ	好きでいてよかった　二人でいるだけで幸せだから
カラフルな想いこの胸にはじけ飛ぶ　ステレオボリューム上げて	行き先は未定　行けるとこまで行ければ　それだけでいいの
好きでいてよかった　二人でいるだけで幸せだから	カラフルな想いこの胸にしまい込む　夢心地でうたた寝
二人で恋という真っ直ぐな柔らかい日差し浴びて	いくつのときめきや切なさ運んできただろう
ずっと隣り照らし合って　そんな奇跡かみしめるたびに	胸の奥から聞こえてくる「あなたといてよかった」
春夏秋冬　あなたといっぱい色んな花を咲かせてきたね	彩られていくこの世界があの日私の全てになった
雪をかぶった時間が霞んでいかないように	赤や青や桃色...　二人夢集めをした
向日葵のように心も体も全部あなたに向きを定め	守ってくれたあなたらしい優しさで包んで
ほんの小さな喜びだってちゃんと心で膨らんで	育んだ日々忘れられないことばかりだったよね
春夏秋冬　いつだって同じ数だけ花を咲かせてきたね	どんな花びらもあなたとなら愛せるとそう思えたんだよ
春夏秋冬　頬を染めていく色とりどりの愛しさたちで	私の心を目一杯動かしてくれたよね　ありがとう
「慎重」「用心」なんて　たいていは役立たずで	そして気づけるはずよ
そして気づけるはずよ	「思いきり生きてやろう」と
私たちはねそこから学んでいくのさ	「しっかり生きて存在するの」と
自分のルールは自分で　つまらなければすぐに破ればいいのさ	「慎重」「用心」なんて　たいていは役立たずで
くり返す経験が	いろんな顔を持たせる
直感と欲望が　私たちへの最高の助言者	自信を持って　さあ病んだ世界　裂く花になれ
込み上げる憧れ離さず　強くたくましく抱いて	自信を持って　さあ病んだ世界　裂く花になれ
ああ　汚されて塞がれ　また救われて癒され	くり返す経験が
いろんな顔を持たせる	私たちはねそこから学んでいくのさ
もう明日さえ見せられない	君への最後の思いやり
あの日に見つけた真実とは	ちがう道へと…
君はどこへ向かってるの?	君は何を探しているの?
君の幸せを誰より　祈ってたけれど	もう明日さえ見せられない
ゆるぎない真実から	逃れようとしないで
ともに育むことの意味を	それぞれ探そうね
もどかしさを何度くりかえしてきただろう	やがてまわり道をして辿り着く
やがてまわり道をして辿り着く	私の居場所を君が知ることは
逃れようとしないで	君への最後の思いやり
いつも曖昧にしてきた	あの日に見つけた真実とは
それぞれ探そうね	君への最後の思いやり
私の居場所を君が知ることは	決して二度と来るはずもないでしょう
涙さえこぼれる　居場所を探せず	もどかしさを何度くりかえしてきただろう
ふたり出来なかった	ともに育むことの意味を
君は何を探しているの?	私にその手をさしのべずに
静かに街を冷やす雨は	疲れ果て眠るふたりにこぼれて
真実はあまりにも繊細だから	いつも曖昧にしてきた
決して二度と来るはずもないでしょう	君への最後の思いやり
君を愛したすべての時間	君はいつだって　君のことばかり
疲れ果て眠るふたりにこぼれて	愛がまたひとつとね　消えてく…
君はいつだって　君のことばかり	信じてたすべてが私を壊す
いつもすぐそばにある	ゆるぎない真実から
外せないで　君の電話　望みつないでた	君が隣にいる夢で目覚めた朝は
君が隣にいる夢で目覚めた朝は	また1から10まで　君で回る日もあるよ
ずっと　ずっと　ずっと　おそろいのストラップ	外せないで　君の電話　望みつないでた
すごく大事な時間だったから	さよならに愛を込め　思い出だけを胸にしまい駆け出すよ
忘れないよ　君と包み合って	人を愛する喜びに敵うものは無いと知った
見つめ合って　暖かくて　時も止めて愛した	すごく大事な時間(とき)だったから
すごく大事な時間(とき)だったから	涙を始まりに　飛び立つ季節　輝きに変えてくよ
白い雪がこんなに冷たかったんだって	忘れていた自分に気付いて　君思い出す
大きな背中に赤い幸せを映していた	白い雪がこんなに冷たかったんだって
いつも　いつも　いつも　コートの袖つかんで	大きな背中に赤い幸せを映していた
君との出逢い　それは夢をくれた	見つめ合って　暖かくて　時も止めて愛した
人を愛する喜びに敵うものは無いと知った	すごく大事な時間だったから
君の心につながるように	私たちの歩く道はちがってもね
言葉にならない気持ち	言葉とはね別の気持ちに
私の詞(ことば)が君へ	君の力につながるように
心開くこと難しいと思ってしまうけれど	ねぇ　閉ざさないで
言葉が君の中や外で	広がって力になるから
ほんとに大切な人ならば	いつかはすべて伝わるよね
たとえ今は伝わらずにいても	ほんとに大切な人ならば
私たちの歩く道はちがってもね	いつも心はつながってる
私たちはそんなものを	感じられる力を持っているんだから
伝えきれないかもしれないと	時々不安になるけど
心の中のすべての想いを	どんなにどんなにね伝えても
大切だと思っている人にさえ	心の中のすべての想いを
君の力につながるように	私たちの歩く道はちがってもね
私の詞(ことば)が君へ	君の心につながるように
言葉とはね別の気持ちに	私たちはそんなものを
何かに恐れて何かを避け	心開くこと難しいと思ってしまうけれど
いつかはすべて伝わるよね	君に伝わると信じているよ
二人の想いがどんな些細なことを	満たすためにも必要だってこと気付かせてくれたよ
二人が手にした時間に永遠なんていうものが	存在するはずもなくて
君の言葉は私に届く	二人の想いがどんな些細なことを
どんなときにでもここに手をのばしてみてよ	いつも最後の勇気を君にあげるから
君への想いで涙にくれることがあるたび	いつも大切な気持ちを気付かせてくれるよ
希望や欲望や夢はそれぞれにあるけれど	二人の願いはひとつに交わると信じてる
いつも最後の勇気を君にあげるから	君の弱さや痛みそれらのすべてまでも
孤独な夜を連れてこないように	どんなときにでもここに手をのばしてみてよ
君のためにならいつだってここにいたい	孤独な夜を連れてこないように
私に聞こえるものが君には届いているの?	君の言葉は私に届く
想いはつなげてくれる気がするよ	きっと多くのことに惑わされるけれども
だけど君とならここから消えてしまったとしても	想いはつなげてくれる気がするよ
君の弱さや痛みそれらのすべてまでも	愛していることを忘れないでいて
私が捧げたたったひとつの心は	君を想い鼓動しているからね
君を想い鼓動しているからね	希望や欲望や夢はそれぞれにあるけれど
私に見えてるものが君の瞳にどう映るの?	君の想いは私に届く
存在するはずもなくて	だけど君とならここから消えてしまったとしても
君の想いは私に届く	君への想いで涙にくれることがあるたび
きっと多くのことに惑わされるけれども	教えてあげるよ　私はこうするよと
2人の思いを半分こにして　私のこころに幸せ混ぜてくれるんだ	おまじないのように　キラキラと　キラキラと
ちゃんと思えてくるよ	君といると明日も　今日よりいい日になりそうだって
君といると　ほんの少しだけれども自分を好きになれるって	思えてくるよ
「ほらね」って微笑む私を　なんだって見抜いてるような	その優しい目と　得意げな表情が　実は好き
不器用にしかね	弱さ見せられないでいるよ
昨日の私は　ねぇ　あれで良かったのかな	寄せては返す波のように
弱さ見せられないでいるよ	こんなに私　見ていてくれる君にさえ
君といると明日も　今日よりいい日になりそうだって	ちゃんと思えてくるよ
出るはずもない答えばかりを並べては考えすぎてた	触るもの　そうしてみんなダメにしていたんだ　きっと
君といると今日は　昨日よりいい日になりそうだって	ちゃんと思えてくるよ
ちゃんと思えてくるよ	「ほらね」って微笑む私を　なんだって見抜いてるような
君といると明日は　今日よりいい日になりそうだって	ちゃんと思えてくるよ
ちゃんと思えてくるよ	2人の思いを半分こにして　私のこころに幸せ混ぜて
ちゃんと思えてくるよ	2人の思いを半分こにして　私のこころに幸せ混ぜてくれるんだ
揺れつづける心へ　海のように広がるぬくもりを	いつでも　ありがと
君といるときっと　まだ見たことのない“ステキ”があるって	ちゃんと思えてくるよ
寄せては返す波のように	揺れつづける心へ　海のように広がるぬくもりを
ちゃんと思えてくるよ	君といると　ほんの少しだけれども自分を好きになれるって
ちゃんと思えてくるよ	君といるとね　ほら　何かがキラキラと　キラキラと
心に幸せ　混ぜてくれるんだ (おまじないのようにキラキラと)	ふたりに幸せ　混ぜてゆくんだ　ずっと (おまじないのようにキラキラと)
ふたりに幸せ　混ぜてゆくんだ　ずっと (おまじないのようにキラキラと)	キラキラと
その優しい熱い想い　目に見えなくても染みついている	あなたのすべてが私の一部になるみたいに
気づけばそっと心灯す　何もかもが愛しく	ささやかでも私からの贈り物　受取ってくれますか？
来年もこの先もずっと　私でありますように	いつかもっと大きくして　あなたのすべてを包めるように
差し出したものよりもきっと　受け取ってきた方が	多い気がするんだ　ほら溢れているよ
あなたのすべてが私の一部になるみたいに	私によく似合う笑顔　あなたが知っていてくれているから
私だけが知る表情(かお)　私だけが呼ぶ愛称(なまえ)	私だけがもらった「離さない」って言葉
“愛”と聞いてあなたの中で　誰より一番に浮かべるのが	来年もこの先もずっと　私でありますように
ありふれたような日常の中　それはずっと	彩り溢れている　あなたとの日々でした
通りすぎた寒い風に　今年もあたたかいあなたの色が	気づけばそっと心灯す　何もかもが愛しく
あなたと出会ってから　もうそんなに経つんだね	いくつの思い出たち　繋いできただろう
半分なくせば　何もがガラクタで	果たしようもない　約束のように
ほんのわずかな違い	人は皆　通り過ぎて気付く
守りぬけるモノが　失くすモノへと	ほんのわずかな違い
吸い込む空気に　もう君が居なくて	吸い込むほどに　ただ苦しくて
吸い込む空気はいつでも	君の温もりがある　手作りだった
季節はまた深くなり	曇る窓　白くいつもの景色をぼやかしていく
弱いからこそ支え合い	巡る哀しみに優しさ持ち寄る
巡る哀しみに優しさ持ち寄る	重ねてくべき　切ない想いを　二人は
曇る窓　白くいつもの景色をぼやかしていく	君との時間のすべても
壊れたなら私が気付くように見せて	直してほしかった
時の流れに色褪せて	壊れたなら私が気付くように見せて
たとえ届かなくても君を	いつだって見守っていれたのに
別れずに輝いてくれたのに	いつまでも輝いてくれたのに
出逢ったあの瞬間に戻してよ	｢もう一度…｣　なんて言わない
分かってても人は繰り返そうと…	愛は儚いものだね
手をのばさずにいれば　きっと	たとえ遠い場所でも君は
出逢いがさよならの始まりと	分かってても人は繰り返そうと…
たとえ遠い場所でも君は	別れずに輝いてくれたのに
もし願いひとつだけ叶うなら	出逢ったあの瞬間に戻してよ
想い閉じ込めていたのなら	たとえ届かなくても君を
大切にしてたのに散りばめて	また壊してしまったの
たとえ遠い場所でも君は	壊れずに輝いてくれたのに
カタチあるものはやがて消えゆく	出逢いがさよならの始まりと
また壊してしまったの	その夜の月が連れ去り隠していった
ひたすらにあなたの方　向いているココロ	こんな時こそ　この愛をあなどっちゃ嫌よ
ねぇダーリン　どうしたの?　うつむいたままじゃない	爪を立て　誰の言葉もいらないって顔ね
ねぇダーリン　悩んだらコーヒーにミルクを	何杯も入れる癖　ほら打ち明けてよ
明日への君を勇気づける愛はどこにあるの?	支える力になりたいと思うたび無力さに負けて
言いすぎた言葉言えない言葉に頬つたわる涙	悔しかったよ本音を伝える勇気がここになくて
君を愛することだけでも	生きる価値になっているから…
あたたかい腕の中、口唇、嘘、なんて…	失くしそうになれば見せる 優しさなんて欲しくない
君がつらく負けそうな夜には私の胸の中で	守ってあげたい癒してあげたい愛のすべてをかけて…
君への想いは揺るがない他に誰も欲しくはない	君を愛することだけでも
君のすべてを閉じ込めていたいこの胸張りさけそう	言いすぎた言葉言えない言葉に頬つたわる涙
悔しかったよ本音を伝える勇気がここになくて	ぶつかることより逃げていることで自分を守ってたよ
君のすべてを閉じ込めていたいこの胸あふれるほど	一人の夜に全ての不安と戦っているときも
迷うだけのうつろな愛ままならない想いで	小さな朝の積み重ね消えてしまいそうで…
凍えそうな夜に抱きしめるほど こぼれてく切なさ	些細な言葉だけに 傷つけられたり時には癒され
一人の夜に全ての不安と戦っているときも	君への想いは揺るがない他に誰も欲しくはない
今もう一度飛び立とう	無謀にさえ見える明日に飛び込んで
体中に強く感じる　新しい始まり	いつもとはちがう目覚め　動き出してくステージ
無謀にさえ見える明日に飛び込んで	試される心　頑張れると信じて
何度も描き飛び立とう	かすかな兆し探し当てながら
かすかな兆し探し当てながら	果てのない旅路はどこまでもつづく
今大きく飛び立とう	無数の光まとって生まれ変わる
無数の光まとって生まれ変わる	この瞳が空の大きさ決めるなら
立ち尽くす場所　行き止まりじゃなく	顔を上げれば　そこが本当は始まりってことも
雨に打たれた日々　後悔や傷痕だって	見つめてきた全てが大事だと気づきはじめてる
小さな不安　蹴っ飛ばしたら	心揺さぶる大きな風に身をゆだねて
そよ風は季節のせいじゃなくてね	君が運んできてくれたよ
忘れないでいるよ	生まれ変わっても君に会えるように
そう　それは　遥か遥か遠く	昔の君と私だったころ
思ってしまうのがね　君なんだ	ひとりぼっちじゃないと言えるのは
ひとりぼっちじゃないと言えるのは	いつも君が守ってくれるから
理由は君のためと言ってもいい?	そよ風は季節のせいじゃなくてね
何故　生まれてきたのか	理由は君のためと言ってもいい?
昔の君と私だったころ	忘れないように　君のその手を
なんだか懐かしいほどに　やさしくて	そう　それは　遥か遥か遠く
いちばんに聞いて欲しいと	思ってしまうのがね　君なんだ
風は吹いてた?　空は青かった?	出逢った日のことを　いくつ思い出せる?
忘れないように　君のその手を	おぼえていようとしてたんだね
君が運んできてくれたよ	すべての愛を連れてゆこう
はじめて感じた　気持ちだったり	風は吹いてた?　空は青かった?
きっとこの季節も何度目かじゃなく　幾度巡り	君とくりかえしてきたんだろうね　きっと
偶然ではなくてね　理由は運命と信じてもいい?	きっとこの季節も何度目かじゃなく　幾度巡り
生まれ変わっても君に会えるように	探さなくても　そう出逢えると教えてくれた
そっと頬に　そえてくれた手は	なんだか懐かしいほどに　やさしくて
君と感じ目にする　それがどんなに小さなことでも	忘れないでいるよ
悲しいことも　つらいことも	いちばんに聞いて欲しいと
はじめて交わした　言葉だったり	はじめて感じた　気持ちだったり
知っているよ　決して弱音吐いたりしない　そんな君だから	ねぇお願い　だめなときは　手のぬくもり　確かめにきてね
君が傷を抱え　一人孤独の中　戦うときには	そっと息を止めて　熱い思いを込め　祈りささげたい
柔らかすぎる愛に抱かれていたよ	きっと失くして気がついたよ小さなぬくもり
抱えきれずにいたよ　この小さな胸には	心の扉　閉ざさずに
まちがっていないものやまっすぐなものを	いつもみせていてくれたんだね
見つけたよ　あの日の答え	君との刻まれた記憶たちは心のどこかで静かに息づいていくよ
今になってね　君の想いの深さが見えそうで	まちがっていないものやまっすぐなものを
見えない力　頼りに…	心の扉　閉ざさずに
心の扉　閉ざさずに	次へと進む新たな不安と迷いを抱えてしまいそうになっても
迷いを青い風に散らそうとしても	抱えきれずにいたよ　この小さな胸には
心の扉　閉ざさずに	強く…強く…
君から私からすべてからも逃げて辿り着いてたのは	どこでもないところだった
どこでもないところだった	もう逃げ道はいらないよ
きっと失くして気がついたよ小さなぬくもり	今になってね　君の想いの深さが見えそうで
二人ともに過ごした時間をもう無駄な日々だったなんて	傷になんかしないよ
君はとっくにみえていたんだね	壊れやすくて守るものなんてないとあきらめてただけだったと…
私が感じていた刺を君にも同じように与えていたのかもしれなかった	何に心を痛めて何に怯えていたのか気にも止めず
何に心を痛めて何に怯えていたのか気にも止めず	縺れてく二人の真実に向き合うのが恐かった
傷になんかしないよ	見つけたよ　あの日の答え
もう逃げ道はいらないよ	たとえ涙を流したとしても私も何も壊れないと知ったから
信じてる…。　愛が最後に勝利もたらすって	だけど酷く怖い夜に愛は敵わず
魔物へこの身すぐに明け渡される	どこまで私戦えばいい？
あなたに渡せられる綺麗な言葉がまだ分からない　分からないの	歩んできた世界の分だけ増えた傷が作り出す迷路
歩んできた世界の分だけ増えた傷が作り出す迷路	どうやって私抜け出せばいい？
だけど酷く怖い夜に愛は敵わず	魔物へこの身すぐに明け渡される
誰かの心を温めたくって　言葉用意しても　この世界じゃ	何もが偽善に　何もが意味無く　目のあたりにするんだ　非力さを
僕は歌う　溢れ覆う戸惑い　みな拭い消すように	混乱は増す時代の中　つじつまをね合わせようと
何が本当で　何が嘘なのか　分からない溢れる情報が	僕らを巻き込む　僕らを追い込む　今日もまた僕は試されてる
憧れに向けて　狂いだす果てない欲望が創った　この世界(ばしょ)で	何が本当で　何が嘘なのか　分からない溢れる情報が
立ち向かって　越えてかなきゃいけないもの　それはきっと	怯えすぎた自分の(この)心が　つくってしまう限界なんだと
悲しみに満ちた街の素顔など	人混みやモノで埋もれにぎわう街のなか呑み込まれ
混乱は増す時代の中　つじつまをね合わせようと	差し出されたその中へとはまってゆく前に
何もが偽善に　何もが意味無く　目のあたりにするんだ　非力さを	失望をまとい眠る夜を何度も知っては
立ち向かおう　あらゆる愛　僅かな真実(リアル)　握りしめて	僕は歌う　溢れ覆う戸惑い　みな拭い消すように
人混みやモノで埋もれにぎわう街のなか呑み込まれ	同じ様な顔して行く人の群れ　また誰か呑み込んでゆく
立ち向かおう　あらゆる愛　わずかな願い　握りしめて	僕は行くよ　こんな心渇ききった楽園の中
僕は行くよ　こんな心渇ききった楽園の中	「諦め」とか「最後(おわり)」に手をのばそうとする君の前に
僕らを巻き込む　僕らを追い込む　今日もまた僕は試されてる	悲しみに満ちた街の素顔など
失望をまとい眠る夜を何度も知っては	それでもね　泣きながらも言い聞かせた
そう　皆　自由と幸せの権利を手にしてる	だから「きっと」「もっと」ってね　僕を動かしてかなきゃ
「諦め」とか「最後(おわり)」に手をのばそうとする君の前に	せめて　優しい光見せてともしつづけてあげたいから
教えようと伝えようとするの	そう ただ冷たいって 孤独だって そんな風に
吹き荒れる風は意地悪に	右側にもう君がいないことだけを
右側にもう君がいないことだけを	教えようと伝えようとするの
もう君なしじゃ 私はこんなに不完全な存在で	どんな言葉ですら言い尽くせないような醜い痛みが
好きだった 君のあの笑顔ばかり浮かぶの 浮かぶの…	おびえた姿強がりで守るしかなく
もうただ一つだけの欲望じゃなくなって	炎になり灰になり舞い散った
街の中 思わず耳をふさいだ そう君の好きな歌	会いたいよ こんなはずじゃなかったの
私の姿に またなす術を無くすの 無くすの…	街の中 思わず耳をふさいだ そう君の好きな歌
苦しくて 溢れる涙に負けてしまうそのたびに	優しく私を呼ぶ声ばかり聞こえるの 聞こえるの…
優しく私を呼ぶ声ばかり聞こえるの 聞こえるの…	知ったの いつだって名前呼んでもらえる
悲しくて そっとこの目開くたび 何一つ変わらない	私の姿に またなす術を無くすの 無くすの…
おびえた姿強がりで守るしかなく	自分を壊してしまうくらい愛してた
あの夜に君にとって私は	もうただ一つだけの欲望じゃなくなって
寂しくて そっとこの目閉じるたび 何一つ変わらない	好きだった 君のあの笑顔ばかり浮かぶの 浮かぶの…
知ったの いつだって名前呼んでもらえる	その距離の近さに守られていたことを
あの日の私は素直じゃなく	あの夜に君にとって私は
陰る日でさえ　陽の光りで	希望の景色を　見せてあげるよ
希望の景色を　見せてあげるよ	私が信じれるのも君しかいない
夜明けには君を　明るく照らす	月となり君を　見守ってるから
私が信じれるのも君しかいない	そのスピードについていくから
私の心が何のためにあるのか　みせてあげるよ	“信じる”ってすごく難しいけれどね　もう恐れないで
月となり君を　見守ってるから	陰る日でさえ　陽の光りで
月となり君を　見守ってるから	君は迷わず私の愛を支えにしていいよ
そのスピードについていくから	私の愛はいつまでも君のためにここにある
私はいつも正直に君のそばにいると誓うよ	人はすべて失ったときに大切なものに気付くから
月となり君を　見守ってるから	忘れないでいて　心は離れないと言ったこと
またモノクロな世界　この瞳に映るすべて　あなたの色へと染めて	あなたにはまって墜ちていく
光が欲しいの　あなたの鮮やかな声で	またモノクロな世界　この瞳に映るすべて　あなたの色へと染めて
冷たい素振りをする　あなたは時に心の中を見せない	何故なの抱きしめたり　何故見つめたり　何故惑わせてゆくの
すべてが崩れそうに惹かれていくの　身体中が熱く	心は諦めても諦めなくても　もう楽にはなれない
あなたほど震えて　あなたほど締めつけて　臆病になるものは無いけど	あなたに満たされ堕ちていく
月が溶けていく前に　この気持ちを悟って　一秒ごとに揺れ乱れ	私に愛を聴かせて
愛ほど切なくて　愛ほど苦しくて痛くて	あなたほど震えて　あなたほど締めつけて　臆病になるものは無いけど
「髪を少し切ったよ…」どうでもいいことだね	いつもの待ち合せ場所　届かない言葉と歩く
空をピンクに染めた桜が散って逝く	それはたくさんの夢が始まる季節の合図
君のいない景色たちは無意味なものばかりで	いつか意味のある美しい思い出になるの?
だけど幻のような匂いの中　僕はまだ	立ち止まって　ただ一人君を思い出す
二人しか味わえない　時間がかけめぐり　ずっとこのままでいれたらな	最後の花火が消える頃に私の肩を　そっと包むその腕に
二人共に思い切り　この熱さかじれば　きっと夏がまた好きになる	パノラマの思い出を君といくつ作ろう　青い海や空に溶けて
胸のグラスの中で弾けるソーダのように	夏色のプリズムくるくるわき上がる
君と夜のコンビニ　買った花火セット	色とりどりの光と煙の中で見た
笑い声が重なる時　家族の支え　仲間の絆	恋人の温もり　友の優しさ　グッとくる空気がそう　深くあたためてく
言葉を繋ぎ　かけがえのない想いをくれる	人に生まれ一番の宝物かもしれない
一人きりだと嘆くそばに空の青さ　風の囁き	花の香り　星の瞬き　ハッとする空気がそう　傷を癒していく
感動って毎日の中に転がっていてそれを	見逃さない人のそばにある
人に生まれ一番の宝物かもしれない	“ありがとう”というあたたかさ
言葉にしない輝きたちを届けてくれる	感動って毎日の中に転がっていてそれを
悲しいもの　苦しいこと　辛く向き合う	すべてに大事な意味があった
僕が生まれてきた理由(ワケ)を知ったような	そんな気がするから
すべてのことに感謝したい	ありがとう　いつもより言いたくなるよ
様々な愛があきらめない強さ	教えてくれたから
すべてに大事な意味があった	ありがとう　それは痛みを知るからこそ
大事にして生きていきたい	生まれた日にもらった奇跡は今も
この時代　この世界　この君がいる	ここに生まれて本当によかった
ありがとう　それは痛みを知るからこそ	深く深い言葉に変わっていくものかもしれない
愛しい場所　愛しい時間　愛しい人	すべてのことに感謝したい
ここで笑い　ここで泣き　ここにいること	大事にして生きていきたい
ありがとう　いつもより言いたくなるよ	君がくれる笑顔に　そして今日は僕の笑顔に
ここに生まれて本当によかった	ありがとう　愛してるとこれ以上の
ありがとう　愛してるとこれ以上の	言葉が見つかるなら僕は迷わず君へと捧げたい
ねえ　この１℃がそっと心の深くて柔らかい場所を優しく包む	ねえ　「ずっとそばにいて」あなたへと言った　あの日を今も覚えているかな
ねえ　「ずっと一緒」だと言ってくれたこと　あの日を今も覚えているよ	ねえ　膨れてく想い　あなたに恋する時間をもっと下さい
その目に見つめられ　声に安らぎ　その手に包まれ	こうしてひとつひとつ　あなたの体温もらってきたから
ねえ　「ずっとそばにいて」あなたへと言った　あの日を今も覚えているかな	ねえ　ほてった想いは今も変わらない　消えない恋であるように
ぎゅっと手を握れば　握りかえしてくれるその	強さに守られて　この恋を信じてきた
ねえ　ほてった想いは今も変わらない　消えない恋であるように	ねえ　ずっとそばにいさせて
あなたのそばにいて空を見上げる　例えばそんな	何気ない時間が私にはとてもただ愛しくて
その温もりになら　このすべてあずけられるよ	どんなもの貰うより幸せとそう思える
微熱帯びてくような想い　出逢った日から感じてる	37℃のこの恋がずっと似合うような私たちでいたいって願う
ねえ　「俺たち」っていつもあなたがふと言う　二人をそう呼ぶのが嬉しい	ねえ　二人でひとつのこの先の未来　あなたと語れますように
この気持ちを言い切れる程　あなたのこと今日も夢見る	愛しさ切なさも限りなくつづいてゆくから
切ない振動をあなたは伝えてくれる　あたたかに	夢を見ているより夢みたいだからねすごく
二人でひとつの温もりを「幸せ」と名付けて	二人でひとつの時間を「夢」と名付けてゆこう
夢を見ているより夢みたいだからねすごく	この心にずっと届けて
この恋はね　この愛はね　永遠だというしるし	あなたと私だけのしるし
この心にずっと届けて	この恋はね　この愛はね　永遠だというしるし
伝えたい想いがありふれた言葉になってしまう	「愛してる」って言葉にした　ねぇその1秒前の
心のある場所を教えてくれるように　じんと熱く	切ない振動をあなたは伝えてくれる　あたたかに
ずっとずっと届け合いたい	この恋はね　この愛はね　永遠だというしるし
愛しさ切なさも限りなくつづいてゆくから	その心にぎゅっと届けたい
喜び安らぎが二人を大きく支えるから	ずっとずっと届け合いたい
その心にぎゅっと届けたい	この言葉も　この想いも　特別だというしるし
こんなに大好きなあなたをもっと好きになりたくて	この気持ちを言い切れる程　あなたのこと今日も夢見る
作り笑いは泣き顔より	人を悲しませるものだと
そんな私を叱って言った	作り笑いは泣き顔より
優しいほどの悲劇と　哀しいほどの喜劇	あの日　裏切りを知った
痛いくらい鮮やかな感情を	閉じ込めるように隠した
「見つけられなくていいから」	私は笑顔で君に言った
子供のように泣きついて	弱さと並び　ふたつの手がつながったとき
体中　君が染み込んでゆくのが	まだ怖かった
触れる温もり　知ってるから	体中　君が染み込んでゆくのが
弱さと並び　ふたつの手がつながったとき	強くなれることを思い出せたよ
冷たい風の奥に思い出し溢れる	痛いくらい鮮やかな感情を
銀色にきらめく粉雪にね	冷たい風の奥に思い出し溢れる
幼い頃感じた　温もりにね	とても似ていた
あれからね	孤独を望むふりをしては強がり
「見つけて ほしかったよずっと」	子供のように泣きついて
「見つけられなくていいから」	そんな私を叱って言った
私は笑顔で君に言った	触れる温もり　知ってるから
日が落ちても　かくれんぼはまだ続けた	君はね　愛想をつかせもせず
揃う笑い声ユニゾって和む　くすぐったい胸	私のような　あなたのような　混ざり合う感じ
私には白く　あなたには黒く　見えたとしても	間違い探しするより二人の答えを探そうよ
もう落としたり見失ったりしたくはないから	心の手紙に綴って閉まっておくよ
君のすべて感じてきたこの心が	仕方ないほどに
一人じゃ持ちきれずにいる	そんな私を何も見ていないフリして
「大好き」や「ありがとう」	そんな言葉じゃ語りきれず
いつだってね君だけは	乗り越えられそうにない壁を
見えない心の手紙	開こうとしてくれたのも読んでくれてたのも
気付けば　いつも　私を守るように見つめる	君の瞳があった
開こうとしてくれたのも読んでくれてたのも	いつだってね君だった
気付けば　いつも　私を守るように抱きしめる	君のすべてがあるよ
いつだってね君だった	きっと最後のページにも私は
今日もね心は君だけであふれてる	ねぇ　永遠に
そんな私を何も見ていないフリして	いつだってね君だけは
ねぇ　永遠に	心の手紙にそっと閉まっておくから
君がくれたこんな想いを	もう落としたり見失ったりしたくはないから
ねぇ　あたたかいよ	今日もね心は君だけであふれてる
誰にも言えずに心の手紙綴っては	一人じゃ持ちきれずにいる
伝えたいこと	今日もね心は君だけであふれてる
君のすべて感じてきたこの心は	仕方ないほどに
仕方ないほどに	伝えたいこと
そんな言葉じゃ語りきれず	見えない心の手紙
仕方ないほどに	ねぇ　あたたかいよ
すれ違いが募った日々　でも最後の日のあなたは優しく	それが苦しくて　いっそ大嫌いになれるほどに去ってほしかった
シンプルなありのままの気持ち	「行かないで」って泣いて言えたら　変わることができたのかな
大事にしてるハートのリング	忘れられない８日記念日　手をつなぎよく歩いた道
シンプルなあなたのその気持ち	飾らないその言葉　笑顔が　今でもただ大切すぎて
忘れられない８日記念日　手をつなぎよく歩いた道	似合うと言ってたワンピース　白いソファー　全てにあなたが映る
飾らないその言葉　笑顔が　今でもただ大切すぎて	私とあなただけで愛したあの日々を　ずっと忘れないでいて
飾らないその言葉　笑顔が　今でもただ大切すぎて	滲んだ目に映る　あなたが幸せにした　私の顔が並ぶ写真
こんなに純粋に人を愛したことはなかった	それが二人の信じた未来　儚くも遠ざけたのかな
「行かないで」って泣いて言えたら　変わることができたのかな	あなた苦しめたくなくて　精一杯　笑顔で告げた「さよなら」
決まった時間に鳴らなくなった着信音	予定の無くなったページ　増えてくカレンダー
ねえ人は生きてゆくこの世界の中で	いくつの大切なものに出逢い失うんだろう？
あなたの愛しい寝顔を見ながら　これ以上ない程の想いをこめて	ひとり言にして優しく呟く　「ありがとう」「ありがとう」あなたが宝物
咲いて溢れる人の中からこの私を選んでくれて	こうして側にいてくれる愛しさよ
あなたの愛しい寝顔を見なから　溢れてこぼれだす想いをそっと	ひとり言にして優しく呟く　「愛してる」「愛してる」これからもずっと
あなたの愛しい寝顔を見ながら　これ以上ない程の想いを込めて	ひとり言にして優しく呟く　知らずにあなたは明日も目覚める
いくつの大切なものに出逢い失うんだろう？	ねえどうかあなたが私にとっての最後の大切なものであるように願う
あなたの愛しい寝顔を見ながら　溢れてこぼれだす想いをそっと	ひとり言にして優しく呟く　知らずにあなたは明日も目覚める
分け合い生きてきたからこそ	幸せは一人きりじゃ持ち切れないものなんだって
奇跡を生きてるって　今感じあう	広い世界の中で出逢うべき人たちが
奇跡を生きてるって　今感じあう	大きさの違う手に大事な意味があって
支えながら支えられて　守りたくて守られていたよね	君と逢えていなければ今の僕はいない
君の愛は僕を本当に幸せにするんだね	この贅沢な気持ち　日ごと宝物になる
僕の一番の優しさが溢れ君に落ちていくよ	それは君が特別に教えてくれた感情(モノ)
誰かが心の手を誰かと繋ぎながら	奇跡を生きてるって　今感じあう
愛をいつも分け与えてくれたすべての人たちに	ありふれた言葉じゃ足りないくらいに感謝するよ
何度も心の手を僕らは繋ぎながら	奇跡を生きてるって　今感じあう
君の一雫広がるよ体中へと	伝わってくる気持ち　そっと満たしてくれる
いつでも心の手を僕らは繋ぎながら	分け合い生きてきたからこそ
ココロ中に甘酸っぱく　実ってる	一日中　君を想ってる　何度も
好きで　好きでね	大好きな　そんな自分に気付く
ココロ中に甘酸っぱく　実ってる	一晩中　君を想ってる夢でも
一日の終わりも　また電話口からのね　君の声	「おやすみ」重なる声が　離れる瞬間　君のことをまた
一日中　君を想ってる　何度も	ねぇ　君は何度私を思い浮かべた?
一晩中　君を想ってる夢でも	ねぇ　君がぐっすりとね　眠れてたらいい
一日の始まりはね　電話口からのね　君の声	その声から伝わるよ　君のね　微笑み　しぐさのすべて
ねぇ　独りじゃ　感じなかった気持ち	ココロ中に甘酸っぱく　実ってる
ねぇ　ふたりで感じたことないくらい	ココロ中に甘く甘く　実らせよう
瞳閉じれば　ほら君を	完璧に思い出せる
強がりはもう捨ててしまおう　自分に嘘はやめて	“一人でもやっていける”　それは哀しい言葉
“一人でもやっていける”　それは哀しい言葉	気づかぬ間に胸の痛み　理由(ワケ)もなく込みあげる
分かっている　一番辿り着きたい場所はいつも	この胸の中にあるはずだから
でも明日を見失うことが不安だから	踏み外せず　あの信号と小さなため息に
素顔のまま　私らしく輝きたい　いつまでも	本当の私だけ強く抱きしめて
ありがとうと自分に言える明日探して	分かっている　一番辿り着きたい場所はいつも
素顔のまま　私らしく生きていたい　これからも	ありがとうと自分に言える明日探して
人ごみの中を流されないように	生きている　自分守って
何かが違うなんてね　思いつづけてるのに	慣れた作り笑い使ってる
なのにどうしてなのかな	一番大切なモノだけがいつも見つからない
素顔のまま　私らしく生きていたい　いつまでも	でも明日を見失うことが不安だから
スタートを切ろう　これまでの日から	君と願う明日を掴む
目覚めたいときだからこそ　その瞳で太陽を見つける	ついついね　受け取り上手な僕らは
「今」という　その瞬間の連続でしょ	たった一つの選んだ道を
僕らはたった一つの命懸けて歩く	そう　夢は限られた時間でしか見れない
スタートを切ろう　君とリセットして	次にくる運(チャンス)試したい
次にくる運試したい	スタートを切ろう　これまでの日から
長く長い「これから」だって	「今」という　その瞬間の連続でしょ
そのままじゃ　なかなか美しいモノになれないんだよね	僕ら　誰もが越えて行きたいものは
スタートを切ろう　君とリセットして	次にくる運試したい
自由の羽に生まれた痛みに	希望も覚悟も吸い上げられていった
スタートを切ろう　区切りをつけて	今すぐ心をぶっ飛ばしてゆこう
希望も覚悟も吸い上げられていった	もう　飛び立つことはしないだろうって
与えられる形じゃなく　言葉じゃなく	名付けようのないものだから
もう　飛び立つことはしないだろうって	君にね出会うまでは
スタートを切ろう　区切りをつけて	願いと諦めの中を　もう揺るがぬように
僕ら　誰もが越えて行きたいものは	与えられる形じゃなく　言葉じゃなく
日が昇る　だからその瞳(め)開くんじゃない	目覚めたいときだからこそ　その瞳で太陽を見つける
次にくる運試したい	スタートを切ろう　区切りをつけて
スタートを切ろう　これまでの日から	君と迷う明日でもいい
ついついね　受け取り上手な僕らは	そのままじゃ　なかなか美しいモノになれないんだよね
次にくる運(チャンス)試したい	スタートを切ろう　これまでの日から
けれど「焦り」は昔よりもね真実味を増してきて	また明日がある限りは何かを選ばなきゃって
ねえ　幸いなことに私たち　ただここに立ち尽くすだけでもね	明日はやって来てくれる
涙も傷も　抱きしめ損ねていくようじゃね	この先　輝くモノを直視できず　くもらせてくだけさ
あきらめ覚えてゆくことを大人になることと擦り替えては	なんだってカッコつけて　平常心装う術　身について
若いつもりがいつしか気付けば　もう全てに答え迫られていて	あきらめ覚えてゆくことを大人になることと擦り替えては
胸の中を強くしていく　大事な言葉を集めて行こう	勇気の底が尽きてしまいそうになっても
何一つ失えずに握りしめてる　そんな指じゃ	きっと僕ら何も上手く掴めないさ
でも君だけはそうじゃなくてね	どうしても離したくはなかった
いくつ白いためいきを　つかせてゆくのだろう?	雪がひとつひとつ 舞い落ちるたび　その冷たさに心が痛むよ
答が出るはずもないのに　探しつづけては	ここに感じるのは痛みだけで　なのにあの頃が懐かしくては
現実から目をそらしてみては　複雑にまざった心を	開くことがむずかしくて　二人でなければこの出来事を…なんて
幼い頃にね　まっさらな目を通して見た雪の世界は	まるでおとぎの国のようで　雪が降るのを楽しみに待ってたのに
あきらめる方が楽だと思ってた	でも君だけはそうじゃなくてね
いつからか欲しいものは　なんだって	あきらめる方が楽だと思ってた
開くことがむずかしくて　二人でなければこの出来事を…なんて	こんな進歩のない私を　雪はあきれて見てるの?
季節がたつのを	見るだけで泣き出しそうで
痛みや苦しみさえも分けあってゆける	そんな二人になりたかった
雪が静かに降り出せば	季節がたつのを
雪がひとつひとつ 舞い落ちるたび　その冷たさに心が痛むよ	ひとつとしてなにもできず　不器用に君を想うばかり
大人になってくたびに　恐れることを知り	現実から目をそらしてみては　複雑にまざった心を
ここに感じるのは痛みだけで　なのにあの頃が懐かしくては	それでも君じゃなきゃだめで　誰より大切なんだろう?
いつも見えない明日に踏み出していくけど	地図のない未来にはまだ失敗はないさ
はるか遠くめがけて投げてゆこう	空っぽの明日に狙い定めてゆこう
この戦いには逃げ場所がなくて	ときに見えない明日に怯えているけど
疲れ果てて眠りにつく夜でさえ　その胸に	忘れないであの日に抱いた想いたちを
たましいが叫ぶまま想いよりずっと	はるか遠くめがけて投げてゆこう
この戦いには逃げ場所がなくて	いつも見えない明日に踏み出していくけど
ときに見えない明日に怯えているけど	今この瞬間は誰にも奪えやしない
たとえば愛や夢に心痛める時には	ひとり震えるときには思い出してほしいよ
全然　もう　手遅れみたいね	危なすぎるけど　だけど私には最高よ　あなたが誰より私を
注意：「誘惑とはリスクがつきもの」	全然　もう　手遅れみたいね
効能：「息を呑むような　圧倒的な魅力に触れられる」	成分：「甘美、優雅　そして魅惑、神秘、魔性的」ね
成分：「甘美、優雅　そして魅惑、神秘、魔性的」ね	用法用量：「一晩中　何回でも好きなだけ」
猛毒か媚薬か	前後不覚になる　陶酔の行きついた果てで
手遅れよ　その一口が	体中　じっくり　まわっていく
一度舞い上がれば　簡単には降りては来れない	危なすぎるけど　だけど私には最高よ　止めないで
前後不覚になる　陶酔の行きついた果てで	湧いてくる悪い官職に　たえず崩れるの　壊れるの
天国か地獄か	一度舞い上がれば　簡単には降りては来れない
支配される　魅了される　どこまでも虜にさせる	あなたには　もう完全に　引きずり込まれていく
誰かが誘ってる　優しいね道だとか	誰かが口にする真実さえ置いてくんだ
夢はね　熱い本音しか聞かない	恐れを解き
いろんな空の下　繰り広がる悲劇よ	信じるという光だけが闇を照らしてゆける
振り返るたびにね失くしたもの眩しく見え	都合のいい場面へと心鈍らせないで
期待されてるとか　あきらめられてるだとか	誰かのね満足のため生きてるわけじゃない
後悔となるのは失敗することじゃなくて	真剣に挑めずにいた心の方
誰もが胸に叶う夢持ってる	恐れを解き
心に響かせてファンファーレ　「願えば叶う」	思い込みこそがまず最大のパワー
強がりな所よく似ていたね　自分の思いばかり押しつけてた	喧嘩して君に投げつけた時計　何千時間刻み合ったのに
君のせいで訪れる明けない夜も苦しい呼吸も全部捨てていこう	きっとこれでよかった言い聞かせるように君を忘れようと演じ続けている
いつも笑顔を選んでる泣かないように　止まったままの時と心を連れて	どんなに心揺れても崩れたとしても押し潰して閉じる　素直にいれたなら
聞かせないで声なんて	ねえ戻さないで前に進みたいけどまだこんなに愛してる
二度と聞くことなんてないと思ってた着信音が鳴る　今さら何故？	何も無いよ話すことなんてもう何も　忘れ去ってくだけ
あれから一度だけ君を見かけた　知らない誰かが隣にいて	守るようにその手握っていたね　思わず目を反らして思った
この胸の痛みが壊れるほどもっと	ぶっきらぼうに がむしゃらに 私を抱きしめて
愛の始まりの頃のようにもっと	その腕の中にだけ見つけられるから
愛を告げられるたび 私の心はもう	不安になりみるみる歪んで そっと苦しくなるよ
体がおれるほど包んで欲しいよ	携帯を握りしめ時計の音の中
君が愛の言葉を 私に告げるたび	君の心が穏やかになり 平気になってくとしたら
戸惑う傷つきやすい気持ち	そう それはきっと私が弱いんじゃなく
抱きしめた力での強さで気持ちをね	“計れやしない”のと”計れる”の思いが
体がおれるぼど包んで欲しいよ	抱きしめた力での強さで気持ちをね
淋しさだけが積もる 孤独で静かな夜	会えない時間たちに切なさが溢れて止まらない私
ねぇ いつから? あの頃は君もそうだったよね	“愛”って頭で分かってても
「信じていれば平気」と君は…	ねぇ いつから? あの頃は君もそうだったよね
その腕の中にだけ見つけられるから	私の安らぎも正しさも答えも 君の中で
君への想いが強いからだよ	この胸を焦がしすぎてしまう
もっと痛く もっときつく 私を抱きしめて	この胸の痛みが壊れるほどもっと
君の心が穏やかになり 平気になってくとしたら	愛を告げられるたび 私の心はもう
ぶっきらぼうに がむしゃらに 私を抱きしめて	体がおれるほど包んで欲しいよ
そう それはきっと私が弱いんじゃなく	君への想いが強いからだよ
“愛”って頭で分かってても	心が承知しないものだった
ぶっきらぼうに がむしゃらに 私を抱きしめて	愛はここにあるっていつも見させていて
ぶっきらぼうに がむしゃらに 私を抱きしめて	体がおれるぼど包んで欲しいよ
もっと痛く もっときつく 私を抱きしめて	愛の始まりの頃のようにもっと
携帯を握りしめ時計の音の中	毛布で切ない想い暖めながら
清く美しきもの　汚れ醜きものを	眩く輝いてるもの　佇しく冷酷なものを
君がいる　そばにいる　それだけで　心はいつもすぐそこに見る	幸運らしき　希望らしき　遥かな夢らしきものを
眩く輝いてるもの　佇しく冷酷なものを	目にし　私たちは
嬉しくて涙して　悲しいのに泣けなくて	たまらなく愛しい日にも　ちょっとだけ喧嘩の日にも
たまらなく愛しい日にも　ちょっとだけ喧嘩の日にも	君は大切な人
「こころ」　それは何よりも　ときに　弱く　脆く　儚く	移ろい　壊れ　崩れてく　怯え果ててしまうもので
少しずつ　少しずつ　知らぬ間に　自ら心に巻きつけた	鎖は錆びて　ほどけなくなる　消えがたい傷まで刻む
君や誰かに見せてる強さと　そして君だけが見た弱さの中に	どれだけほんとの私を　君は見抜いてくれる？　認めてくれる？
移ろい　壊れ　崩れてく　怯え果ててしまうもので	少しずつ　少しずつ　知らぬ間に　自ら心に巻きつけた
ここに生きていること　いつか死にゆくことを	清く美しきもの　汚れ醜きものを
君がいる　ここにいる　それだけが　これからも私のちからとなっていくの	そして「あきらめ」だけはできないって思えるの
熱く　燃ゆる　勇ましく　凛として揺るがぬもので	君がいる　そばにいる　それだけで　心はいつもすぐそこに見る
「こころ」　それは何よりも　ときに　強く　堅く　貫く	熱く　燃ゆる　勇ましく　凛として揺るがぬもので
信じてたいものさえも　信じられないときがある	君がいる　ここにいる　それだけが　これからも私のちからとなっていくの
この胸を焦がすこと　この胸が疼くこと	嬉しくて涙して　悲しいのに泣けなくて
「こころ」　それはいつの日も　光と闇がひしめき合い	信じてたいものさえも　信じられないときがある
どこでどうなってしまったのかな	何もかもが突然に僕の手からこぼれ落ちたあの日々
胸の扉開けたら傘をさし歩き出そう	いつもの道とは違う曲角まがろう
また繰り返すだけの明日にならないため	悲しみにあてもなく座りこまないように
さよならの恋　泣き明かす日々	たった一秒も生きることがとても辛い　そんな時間の中で
飲みかけのカップ　手を止めたまま　滲んでいく瞳	悲しみと一緒にこの店へと来るのは何度目だろう
あてにならない天気予報　降りだす雨	窓の外映る　歩道に花びらはらはら舞い落ちてゆく
言葉にできない涙の奥　一人きり探した	また繰り返すだけの明日にならないため
小さな勇気を僕の空に消さないと誓った	胸の扉開けたら傘をさし歩き出そう
涙の奥の小さな勇気　抱きしめて思った	できることは自分の全て信じること
今の悲しさを乗り越えれた自分を未来の自分は感謝するだろう	自分を変えてくことで道はきっとずっと繋がってく